uuid,female,male,other,skip,total
007f7ffe-65df-4166-afad-f3c8934afd8d,0,15,0,0,15
008ca7b1-fd32-420f-b710-d49fe8e34b05,0,73,0,0,73
00c37436-a45e-46d4-9748-7d05c807beb4,0,20,1,0,21
014d4597-80e2-4dbf-926c-e26e0a6ddea6,0,20,0,0,20
014d5b06-71f0-469b-b02c-994885f00e0a,74,2,0,0,76
015d8fc7-106c-4e68-a6dc-ab7839e640b1,1,80,0,1,82
01788110-595e-4cc4-b485-915f1b5f837b,15,0,0,0,15
01b32a30-eb2a-4386-ab5d-6d9e214c9846,13,1,0,1,15
01b88f46-2739-4fec-b516-ba807873f0fa,0,73,0,1,74
01e540c6-127a-4d52-b709-f6480e3d1203,0,15,0,0,15
01fbdbc4-1cf7-4da3-a91c-1df42f806716,0,74,0,0,74
020580fd-befb-4026-8489-03965c5a9c1b,0,21,0,0,21
02571a0d-b8ef-4450-af30-0f06727331ec,1,44,0,34,79
0273a4ee-2f19-451f-b6e8-1301739f3ad2,1,19,0,1,21
02d972fc-caaf-43f8-82d0-d5ceef9dcb12,0,15,0,0,15
03413153-5c76-4dd8-8a5c-b257b852b04e,0,72,0,0,72
037cf2e0-cd44-49f9-88a8-469d4cf025b4,18,0,0,0,18
03ace867-9e44-4230-8f8a-4e8238c031e1,0,19,0,1,20
03ba2cd5-25fc-4798-b506-85de02e6b3dc,0,36,0,0,36
03c9e793-ddb9-4694-8e2b-96e1440cb5d2,0,81,0,1,82
040564ec-bc73-497c-807f-6ca156abce7e,0,76,0,0,76
040af3f2-7c41-4bc2-91e4-202b6b941e83,14,1,0,0,15
044575b3-8826-48e3-a053-069dc1e8298c,0,70,0,1,71
044fbecb-3941-4ee5-a169-f70981438191,0,15,0,0,15
049775bf-98e8-4ace-af99-5e62b7374a71,18,3,0,0,21
04b64dd4-afdb-4d98-aa57-fdd33a08c37a,15,0,0,0,15
050b8e6e-9e83-4e85-8653-4ba6a5f93d66,73,2,0,2,77
0520e866-da50-4c0c-89f4-c85506e501a0,0,74,0,0,74
056b3f3e-d0f1-4b6c-b88b-481c72dfc516,69,3,0,2,74
057a0ad4-e123-4c2a-9197-01eccf8d10c4,1,64,0,0,65
0587c76d-8e7a-4371-9622-839cef36fb21,0,12,0,5,17
0588816f-94b5-4397-88f6-f3fdca0f94f0,0,36,0,0,36
0592cc7e-bfd0-4a8f-9d88-dcbfecb146d0,0,34,1,0,35
0614dceb-ec97-44e8-aaf3-6bf750a3dbe4,0,15,0,0,15
062e31d4-4875-42f6-b8d2-067198d13dd4,0,69,0,0,69
06520e41-fd86-4fe1-a14b-7f26c95aa12f,0,19,0,0,19
065a5438-13fe-4e63-9d76-c2f9d19c7c9c,0,65,0,3,68
065c92b3-06e2-45d9-9660-b29c1d05a641,0,34,1,0,35
06a11ed6-ea68-4c59-a0c6-76a0142eb8dc,0,71,0,0,71
06a96115-0ad5-40d2-b603-7c4131ee6dcd,69,0,0,0,69
06c8a2d3-1ac8-4043-8a0f-6d751bb6842f,0,75,0,3,78
06d861c5-824a-40da-8997-fc9c2e67f4e2,0,35,1,0,36
06e96755-02b0-459b-8e0e-319c457b01e3,0,15,0,0,15
073eaa7a-f3a1-4632-897b-24dc8ed3eec5,33,2,0,1,36
07779ad8-642f-4a99-89ef-ab05d7fb4b63,0,73,0,1,74
077d5ba0-5560-4245-92ec-fb6dd5757966,0,79,0,0,79
07991852-ae92-497a-8634-dcac81fa9675,82,0,0,1,83
081f6dce-eb24-4017-b3c6-df180c5ab9f6,74,1,0,1,76
082890b2-16a8-4761-b83d-8a94b7f18b56,0,15,0,0,15
0847621f-ad48-401d-aeb7-f7adcb307f76,0,78,0,0,78
0887c5ac-1ea6-4f35-86f4-4b8fae339b56,0,33,1,0,34
08bcc8bc-d6c2-472d-9189-77e54824b0b5,0,20,1,0,21
08be88dd-4e53-431c-b82a-c25137f40fc7,0,15,0,0,15
098d0721-0d82-43be-be1e-f8da8f5335ed,0,15,0,0,15
09ac3392-082d-463a-bee6-6b2b8afc2b41,1,72,0,0,73
09bbf29d-72b6-4958-a7e1-26856b2cdf27,1,75,0,0,76
09c9fd75-3e38-4bef-9518-9551f67019fe,0,76,0,1,77
09cd8b28-cbd7-446e-b204-481a6dcc6b7a,73,1,0,0,74
0a333d66-3357-4b71-a6cc-53205f83b1a2,0,74,1,0,75
0a3f1300-b546-446c-83d8-5f0177ea0278,0,20,0,1,21
0aa89500-e6d7-4673-989d-319894053165,79,0,0,0,79
0aaaf8cd-0db3-4bcd-93b8-fb12f1377825,19,1,0,0,20
0ab91bca-01c5-42c6-a54e-0be50e6d18c3,0,81,0,1,82
0b03d9ac-ba9b-4d38-9b2d-286da94b66b1,0,69,0,0,69
0b3e4514-1198-4fbb-a272-d03ce8818cf8,1,68,0,1,70
0bc0cdb4-2dd7-41a0-a205-f919032dafa4,1,14,0,3,18
0bd40fce-62f6-40d7-99f5-0f845540c11f,0,15,0,0,15
0c030463-eff6-45a3-b63e-c5eb3ffab6e4,81,4,0,1,86
0cadb902-a78f-4821-99e1-1f86237a3e91,0,14,0,0,14
0cb313bb-1c86-4054-adb9-d8527f652601,0,78,1,0,79
0ce334f4-755b-49ab-91ed-5dccc485797a,0,36,0,0,36
0d13e9d4-e38b-4651-9680-1d3b7951edb1,0,73,0,0,73
0d5db2c5-773d-4d63-88c4-6a0e9c888873,0,36,0,0,36
0d83911a-e7ee-4e68-a551-b961dd508257,0,20,0,0,20
0e74d378-7a84-4bc6-914f-4be811c86157,0,15,0,0,15
0e9df3c0-8a92-4a06-bf83-72ada7e8c812,14,1,0,0,15
0eb0b97e-4a72-4545-81a7-59bd4c85a9a1,0,74,0,0,74
0f2aff09-e0a1-4964-bc55-f21946ad7696,0,78,0,0,78
0f316d11-27f5-4dd9-b94c-94f1d36a58bc,0,71,0,1,72
0f3877fb-838c-4857-b8b1-d168e3ed7b3b,0,20,0,0,20
0f4e84b0-468b-4a73-a5a4-29172cd07f5c,0,19,0,0,19
0f617c11-f463-4b85-b4ef-5675d21e0955,1,72,0,0,73
0ff3f31a-8ae3-4902-9f8e-9085a58909e6,0,14,0,1,15
10036639-4201-4ef3-aefe-1ac2f3534c92,0,15,0,0,15
1020ed04-030d-47e5-baeb-827505778d7a,0,34,0,0,34
107c77ee-16fc-4def-a825-bb66ea09f022,0,35,0,1,36
10e4c7d6-349b-4d0c-8366-481dbe6c9485,75,0,0,0,75
10f2b450-ff3b-41b0-af25-4402532f0fbf,0,73,0,0,73
10fdca28-0ac2-486a-ac61-bdf0eee59baf,72,0,0,0,72
111e42f6-9a35-4646-92d4-bb8fca158d55,0,35,0,0,35
113ef5d5-14f7-40cd-856b-ffac355a19c1,0,15,0,0,15
114f8760-536c-4e1b-81c3-6197263b1b29,0,72,0,0,72
1171194d-3997-4cd1-b859-9e8efaaaa534,1,71,0,0,72
1171bfd2-c797-4d95-a021-9fee7a111188,1,83,0,0,84
119a93d0-84b9-412f-bf43-6fa4eb852fdb,81,0,0,0,81
119b1817-479d-442f-94fa-3b2f899ad624,0,15,0,0,15
11ee4f47-4cf7-4630-92b4-0f76e38ca918,0,35,1,0,36
11f496a9-9f95-434d-bd59-6eb08103a9a9,69,1,0,1,71
1234a6f8-6d85-42fa-8ff6-81b0f96d8494,0,70,0,0,70
123a9485-d504-4016-996f-f62b921428a4,0,77,0,0,77
125d302b-ea01-44c7-80c5-bae93f6aca9d,1,71,0,0,72
126a78d1-20d5-415b-b26b-4b9861b7578f,0,15,0,0,15
127ccb5c-4161-49ad-9182-80cf1030c13b,34,2,0,0,36
12c8177c-dfa3-433f-978b-e46a89d4d3ae,1,78,0,0,79
13073e6b-b907-4a21-b588-211ed9a0a9bb,1,78,0,1,80
1337fc01-9c90-46b3-aec4-a689e01227ba,4,15,0,6,25
137381e3-a055-4cd3-868c-38178e8701ae,0,22,0,0,22
137712ad-ed6b-48f4-9863-4e245b3bf23e,0,19,0,0,19
1383f5a2-0832-435e-9ddf-27756bf8f753,0,15,0,0,15
139a31fb-787c-4e85-bdfc-15425c334e0f,0,34,0,0,34
139dc8e1-884d-47c6-bc6c-e00bdcb27220,0,34,0,0,34
13f416cb-53bf-4141-be34-42a16be97249,83,0,0,1,84
14297f22-111a-414d-8b65-30748063fc53,0,14,0,0,14
143e9107-f2b6-4c8a-b51c-4b47647d4ef4,0,73,0,3,76
143ea45d-404b-4248-b327-1f052c801536,69,1,0,1,71
14527992-e8b9-4280-a411-4dc5a87abd80,0,2,0,0,2
14573aa9-0e99-4ab8-b7ba-5443e59df132,0,72,0,1,73
145cbe9f-dc13-4d8a-8214-47fb42716d5c,0,21,0,0,21
1495e228-5639-4671-9298-c828f3e65fe9,0,15,0,0,15
1499f26e-8607-4ec3-a703-31f99d002fc8,73,1,1,0,75
14c3d819-a56c-4fa1-81c6-02f143fbec4e,0,35,0,0,35
150dd3ad-d13e-468f-b9a5-b0ee4b5411bf,73,0,0,2,75
15277ba3-b652-426d-8f99-b7b0e612dc4a,71,1,0,0,72
153ff790-1a0f-4298-90df-3c71708ad54f,0,72,0,0,72
155ae63b-f59e-4b3a-a3a4-72a175c2bbfe,0,18,0,0,18
155fabe2-e23d-459f-9fbe-22da3e3cbd57,0,15,0,0,15
1569017a-5e21-4850-87cf-9c553d0d233c,15,0,0,0,15
157be53d-fcb5-4923-982a-1f174932784d,0,15,0,0,15
15b9159e-715c-48ec-8116-77b707483fed,0,78,0,0,78
15e8ec17-f95e-4576-97ab-501568a9a336,73,2,0,3,78
15ef0954-7331-4a49-8dab-d44ee67492da,0,15,0,0,15
166f4f53-c421-40b1-aa62-10e3a206728b,0,70,0,1,71
168cb977-e5df-4cb2-865f-84d51687502e,0,75,0,2,77
16c11dfa-2ccb-4d3c-a0d5-f5982032f86a,0,19,0,0,19
16d17cad-d695-485b-9ac9-ad3df794d20b,1,69,0,0,70
1748afe1-a8ea-424a-a129-4e2532ca7b40,0,15,0,0,15
1748dfbe-822c-438d-8983-5beaff89f40a,0,71,0,5,76
174bac31-e869-4225-bd61-c53f88a47b59,80,1,0,1,82
17bae9e7-1d8d-4425-ba72-2e0d312f0bac,0,73,0,0,73
17e5c530-9988-41a0-8863-5954e4417752,0,15,0,0,15
1807f856-d641-4939-b768-a64d8ed1641b,76,3,0,0,79
181a47fa-6979-4926-8572-12465f80cc43,15,0,0,0,15
187b8099-5df1-4b23-bf2a-9742104f438f,0,76,0,0,76
18a9f1f8-ba92-45a9-86f3-e651b8ae020e,0,77,0,1,78
18be9567-0583-4f3b-a957-34b425ef988a,0,70,0,0,70
18da8cfd-c352-425b-aebf-25ac6032b9fb,0,75,0,0,75
1909c8c9-0ef3-46d5-aac8-80f5a9b05746,0,35,0,0,35
19385dcf-28ca-4b60-a9c9-f4832f3948ce,1,66,0,2,69
19623ca6-b345-483d-90cf-99ffff46ceb3,0,15,0,0,15
19941d9a-7683-4cf9-b0d8-30cad46a4df3,78,0,0,0,78
19d334b7-e46d-4627-ad4a-cf9e0cbf19e3,15,0,0,0,15
19ef96d4-962a-4244-a77d-f2c0b47b82e0,70,2,0,0,72
1a06e628-2403-4d33-8b80-0f6dc2352cc9,0,72,0,1,73
1a23f048-0df5-4e4b-aae0-30da4d1a47a5,0,80,0,0,80
1a4791ff-10cf-4c80-ad1e-66fb88ab77ca,13,2,0,0,15
1a5f95ec-e9a3-43e7-aa1d-c070f5ec0d1e,0,76,0,0,76
1a69ee3e-f193-42f5-8da3-ae8a4a6d4aa5,0,71,1,0,72
1a701ba1-5085-4023-890f-6a5586583beb,0,69,0,1,70
1a95a1f7-e7d6-428f-9719-33105e9b63c6,0,73,0,1,74
1ab811f9-fea7-4a9c-9131-3c024206dbf2,0,15,0,0,15
1ab9a1a7-39bb-46da-9372-6950b9599037,1,14,0,0,15
1af85f4b-0e63-446e-91d2-a4809adeb14d,0,14,1,0,15
1bade13c-affd-485f-9b52-df22ee76aa3b,0,15,0,0,15
1bff3184-0dd5-4732-8c1f-e54a63631fa8,1,66,0,0,67
1c037604-c96a-4f5f-ad2d-6e7572e14f4b,0,71,0,1,72
1c078ab4-8bde-4ba2-9c99-560298af676e,15,0,0,0,15
1c0b9247-9666-4656-bed4-9c845de1f6cf,0,75,1,1,77
1c2760f1-0d8f-4357-bb6c-4e617d35ec08,77,0,0,1,78
1c4fb4f9-510f-4134-909d-6cbc174cfab1,1,73,0,2,76
1c779600-b281-43c7-bd76-4038ea19f5e3,14,0,0,1,15
1c7ee5e0-df60-4fd3-95f7-cdf5d51fe9cb,73,3,1,0,77
1c9252f2-4a9f-4546-85b8-ffd76d3eb0c7,0,32,1,1,34
1d16fa06-1687-4f3c-8bb6-b27fb9c4ef3f,69,0,0,2,71
1d311f43-2535-4104-b213-33c512f996ae,0,20,0,0,20
1d8899ba-88ae-4d78-8f3a-46b2a67031eb,1,74,0,0,75
1db798fa-1beb-4d03-b4ba-151f48b7a0fa,78,1,0,0,79
1e081e07-f220-4953-999b-e37d977adbe1,0,36,0,0,36
1e6383b9-a89e-43df-a15e-df6dcf677e11,0,35,0,0,35
1e693d68-923e-44d6-8be8-c50b551f18bc,0,15,0,0,15
1e7b9584-c017-4a34-a6d5-722f523997ae,0,19,0,0,19
1eac4422-edd6-4518-9cd3-08cbc0e6aa59,1,70,0,0,71
1ecc9459-180e-4849-9ba1-fd14a72f33aa,0,14,0,0,14
1f1a16f3-9541-4123-8ea3-159eac5a2228,33,0,0,2,35
1f1dfb8a-3ea1-40ad-9a82-8b7d37643733,0,16,0,3,19
1f517ead-ff14-4114-8842-e39ff2aab2a8,0,77,0,1,78
1f79103c-ec03-4265-957d-73d7a3307753,0,36,0,0,36
1f8cceb7-c8df-4095-981e-e35221da8d88,0,76,0,0,76
1f96d908-7362-44de-bdf2-c6723f1925ea,0,76,0,0,76
1fb3d066-9628-4c13-92cc-b3bad9ab8bf3,75,3,0,0,78
1ff848e2-a117-450f-9079-dd57ccc7a34d,0,20,0,0,20
2005f337-e88f-4ee3-b899-f1496f636a10,1,66,0,2,69
20093f82-3de6-44e0-998a-a5d6bcade72a,0,36,0,0,36
203d8847-a662-4c89-b518-46d054d62f33,0,74,0,1,75
2052c5d9-af0a-443e-ac35-98eb0cf40f80,0,71,2,0,73
2075ae12-407f-4ee9-a904-88408606b1ec,0,23,0,0,23
207e6310-58ad-47b7-955f-7611e45a06ee,8,1,0,6,15
20ddb7c9-251b-4a6b-b939-b148dd0709fb,0,15,0,0,15
20e47013-df7b-45e4-a846-77651c1a4ec1,0,80,0,0,80
20e5905d-d24a-4a88-9c9e-994d196a4d65,0,15,0,0,15
211bd562-6315-4078-92c7-b7c11d22b810,0,74,0,1,75
2148a0c3-5139-4f6f-a565-f10979f1beb0,73,2,0,0,75
214b88b3-53ac-4f82-bc56-23dba1c65179,0,15,0,0,15
21ab2321-4ac4-482b-97a6-4cd8c3db6a28,0,15,0,0,15
21cc6a9d-f7ba-4ec0-8d2e-f680e0aa1488,20,0,0,0,20
221f0507-8cde-4fe3-9136-c04a73975a9c,0,35,0,0,35
2235c51b-63c8-4261-be64-87cbce9a3011,74,1,0,2,77
225d07cf-741f-48fd-aded-8b07aaa5b379,0,20,0,0,20
2289c432-f4a6-4858-bc57-4834365df4c2,0,15,0,0,15
22a4b1c1-5b25-4a19-b0dc-a7d0d5e63573,0,75,0,1,76
22c9140c-2f66-423f-bf2d-7efc56e74525,0,35,0,0,35
22e0d72d-135d-4c62-8444-6d00478f03a3,79,1,0,1,81
22e129e6-5fda-4875-9f95-b71f32b04c4a,0,34,0,0,34
23176033-aa20-4753-bb2f-8ce98c164ddb,0,18,0,0,18
232bacdc-ee1f-44e3-bdac-cda63dbcbddb,0,77,0,0,77
23371fb0-5e04-46a9-b703-77154189c068,0,20,0,0,20
233f4091-1712-49d6-bba7-74f30fd3bea9,72,1,0,0,73
23452734-7d70-4484-985a-09a3ec17ad5a,0,15,0,0,15
234ac83e-4b22-4157-a32f-acce2d68df3a,32,3,0,0,35
237e83e4-3815-4bb8-80fc-2ce83cc2290c,0,76,0,1,77
2396b05f-1284-4961-aba8-36d8c288c7d3,1,26,1,10,38
23d44655-98bd-4365-9b4c-68dad02d9ba6,0,15,0,0,15
23d74d7d-3cdb-4e4c-bb3f-f96769998a6d,1,78,0,0,79
23dd4e8f-7bc8-4d97-95f7-82dd9348f837,74,1,0,1,76
23ed0d0f-d0ce-4e4b-8016-94cc11cdd3e0,19,0,0,0,19
23fa332e-7e88-4560-80a9-c225cd4de979,0,20,0,0,20
24374212-3f85-4e77-bb93-3e8e563d5995,0,73,0,0,73
245968e3-b37c-48d8-83ce-e75d43eaf63e,0,71,0,0,71
246e9651-e848-4bee-8843-328e726d2243,0,15,0,0,15
249a7b78-c4e1-42c7-9e8e-cd035902c431,0,74,0,0,74
24bb3005-cf41-47ff-a14a-498e202028e7,1,14,0,0,15
24edfa54-41b2-4518-a16d-f084f09330c8,69,1,1,1,72
24f8e639-37fe-4521-a19e-6bcc0cb55f3c,32,2,0,0,34
250156fc-8a6d-4945-803f-31eb324aff3c,1,72,0,0,73
250a88f6-c4d9-49b8-b7c2-5616c248a86a,0,75,0,1,76
25e4908f-297d-4824-ad92-58ad1f045858,31,3,0,1,35
25f30064-dfdf-4e38-8846-b9f962acf3b7,1,33,1,0,35
26224523-774a-4f46-bf61-cf575ed0b36a,1,14,0,0,15
2640af68-4a8e-45ab-a52c-1f3ed2a469bd,0,72,0,2,74
269a61ed-fda4-42b9-834b-d673ae74811c,0,75,0,1,76
26b55cc0-fd07-4798-90ed-387dbc115815,33,1,0,0,34
26d8a079-beed-4d65-8655-4200407ef3c7,33,3,0,0,36
27352be9-c266-498d-8303-f3ce61c30d59,15,0,0,0,15
273b0a66-138d-4252-b38a-05b24e212f15,0,78,0,0,78
279380f6-587f-4f25-b0ac-74de9a138ce2,0,15,0,0,15
27c3efbf-456d-4a47-87fc-cd4af44ea96f,0,19,0,0,19
27ca2af4-7eeb-42b7-b9bd-4d8c338a7031,0,15,0,0,15
28803bc3-3382-4b1f-a558-fe8f81cb8ff0,0,36,0,0,36
28858b88-6ff7-4697-8c6f-737bb603ce09,0,22,0,0,22
28b2c44c-e55f-4898-ac71-a8432f96aabc,0,69,1,0,70
28cc5a9d-e522-4c02-87d1-2213f80d5655,0,72,0,0,72
28e896c1-cb9c-4f2f-b4d0-f42e0977efe4,0,19,1,0,20
2915b95c-e0d5-435d-aa38-bcd8ee4bbda4,0,73,0,0,73
29aa8774-ba80-409c-a2c8-1830d1076db2,71,0,0,0,71
29e1f71e-4a96-4e5b-9a17-52c4a88bb458,0,34,0,0,34
29f4f628-260c-4418-971d-2a92859e5c05,0,73,0,0,73
29fadfd7-e2d0-4a8a-b3df-7fa0b958a37f,0,19,0,3,22
2a4ba58e-05b4-4cbb-8697-c4dc115bcb85,74,0,0,0,74
2a551c45-502a-40ea-bd5c-842cbe1357f4,0,79,0,1,80
2aa3a984-6047-4a26-81c6-770eda29d1b0,28,1,0,9,38
2ac22233-f18b-4d08-9104-47dc9f6974b7,0,34,0,0,34
2adbd38f-e0ab-480e-b622-0ce5d7e5a715,0,33,0,2,35
2ade107c-8d1b-4c25-bf2a-9473b68132a3,0,13,0,2,15
2b0c7ff1-ad7f-4203-b6bf-995438ec5d35,0,20,0,0,20
2b8fb521-329e-46fd-8603-71083cf8de8b,67,0,0,1,68
2b90bed6-db37-4ed4-b879-a4096e9dbc1d,0,79,0,0,79
2ba3d9c5-ad63-4aba-b61d-e00a28e9e7d6,1,26,0,13,40
2c17792c-a3c3-461a-866c-5d4b3ce242e3,1,13,0,4,18
2c2dfddb-cc71-42de-855f-ede34ba308c7,0,15,0,0,15
2c4f0d97-6ad1-42a3-9285-eb9664e9dde4,0,35,1,0,36
2c6124e6-4870-4b2f-a289-7586a6c51693,0,15,0,0,15
2d17399b-b3da-43b6-97b9-5131d4295041,20,0,0,0,20
2d3ac319-6d21-4385-a01b-dea2dc0263e7,0,21,0,0,21
2d61fa08-5997-4421-b126-7f7b3c62a110,0,75,0,2,77
2d89c66c-056b-4728-b92d-a0a1b0cfb1f4,0,74,0,0,74
2d9f9841-17a5-47dd-b24a-f4e51e76d900,73,2,0,1,76
2db0a8e5-0661-454e-9796-6e287c1ae4b4,0,15,0,0,15
2dcff9a6-34fa-487b-b1d8-9d0aedaecf5f,20,1,0,0,21
2e1e85f4-faf9-4cca-8b94-bae0565fb57e,0,34,0,0,34
2ea060ee-2886-42c3-a990-e74b28d9817b,0,74,0,0,74
2ef01f46-0d66-4dee-a34f-e23362b62b9b,0,82,0,1,83
2f2fbb55-b48b-4186-b73d-fd2941afc40a,0,19,1,0,20
2f81bf93-b4f0-401f-824f-14cc4e3bd2d9,0,72,0,0,72
3056ce3e-f671-4f93-8c89-26729762a8d7,0,37,0,0,37
309239d4-bba8-4ea3-9ec2-c34cb99f7a9f,0,35,0,0,35
30c2cb3e-48d1-4e7e-ad08-5f6fcb7df391,0,15,0,0,15
3116ad46-35d8-4593-b703-54eeea3befd2,0,34,0,0,34
318d27c7-5eaa-49af-ac2c-78f6685427c2,0,20,0,0,20
319aff12-5850-4bc3-a4d9-ad9945a2f39b,0,35,0,0,35
320423ed-7ba6-47b1-8d5b-a04286504910,0,14,0,0,14
327d7f4a-12c5-4e4e-a886-23e8f528c2a1,15,0,0,0,15
328441c2-e473-41dc-b1f8-40c6713c3c4d,0,74,0,0,74
328e0940-5503-4634-81d5-11f07a68ea17,0,83,0,0,83
32a649b0-4e0d-441b-8e46-cbb9e78084d1,0,74,0,0,74
32d0b385-50d4-4a56-bed0-f355bb5a5243,0,15,0,0,15
330100e1-1dbf-4cdb-97e7-f8e1e8648609,15,0,0,0,15
33830a63-b769-4dc0-8d8d-4e365e0dc601,74,0,0,0,74
33b50128-407d-4353-bdde-82c960ee1a0f,0,34,1,0,35
33dfbf31-d637-4780-9832-58215f3b737d,0,35,0,0,35
33e8219d-8365-4ea9-a3b6-b01b2cf01cc6,76,0,0,0,76
33fe8df1-164f-459e-8706-aa33fe06da74,0,17,0,3,20
34086422-f0c0-4aea-9618-6a96b2d779b4,15,3,0,2,20
342eecb0-18c8-4d15-b298-125b4b7b6fb6,0,15,0,0,15
344f6780-4850-4ff0-ad0c-5d06adc0c06f,0,37,0,0,37
34531d5f-e9e9-48d2-af2c-bc84ef393dfb,1,14,0,0,15
34f3ef9e-1d74-4acd-8205-ed0e7e8f9fb0,0,15,0,0,15
353d695a-966f-49b1-b3af-ffc6ce627f5d,0,75,0,0,75
3569371c-599c-4452-8c92-f776723b5053,0,15,0,0,15
35805436-9eb8-46d4-9820-9087fdb7da28,76,1,0,0,77
3598a709-1626-488c-8b27-836a22403c19,1,14,0,0,15
35bfbc83-a319-44b4-83d3-87b836ff226f,0,21,0,0,21
361e7a9d-bfb5-4856-8b84-cb0cca3e5dd7,1,14,0,0,15
3646a9c1-f54c-41bc-9981-8ad5698e8120,0,81,0,0,81
364fd44a-c93c-48b6-94d6-2d237e6d1060,0,15,0,0,15
36604525-3853-48e3-b5f3-bd9dca222a66,70,3,0,0,73
3679d3c9-6189-4932-a2b6-a2695e7607cc,22,0,0,0,22
36a149e3-ea22-4a46-aa93-29cb4340beb6,0,76,0,0,76
36be8f2b-ea28-40c0-9dc9-03df32857324,73,1,0,0,74
36c6ab70-1e3a-414c-b99e-7b1c84169d9f,0,36,0,0,36
36c6fed8-400d-4ce0-80b4-3e936cc12ba2,0,73,0,0,73
374dd0f4-04dc-4f9c-bf95-2f5416611a48,0,15,0,0,15
376383ea-f61b-41dc-8189-55d17d50b719,0,66,0,1,67
3783fb2d-673c-44a3-b0af-ac9f7a9d1008,0,82,0,0,82
3788fc3e-574a-49a2-befb-f8478190987c,78,0,0,0,78
3879b6fc-76b7-498e-867b-55500d8ed286,0,76,0,1,77
38a8ee49-c02a-4cd9-be9b-0423565c17ab,0,34,0,0,34
39218598-41c2-452f-a3df-ae2492a81025,0,35,0,0,35
393fb4c3-0951-4a68-9f39-0bd1259e4cb7,0,74,1,0,75
39d21c55-5d42-4dfe-882a-a83f597aca37,0,36,0,0,36
39d2b0a4-26e3-4198-b781-6c7ee86b3a7e,2,11,0,5,18
3a088ead-9c69-4681-9819-45adc7b94c13,20,1,0,0,21
3a20d698-05f4-4714-9e3e-3da95fd3b88c,0,78,0,0,78
3a6f850f-f4b6-4e2f-8e5c-cbd8d9ed7ae6,0,71,1,1,73
3a971340-a3ce-4fe2-8afe-835717350e5d,0,74,0,0,74
3ab92737-8013-4958-a3a5-ba4101def1ba,0,15,0,0,15
3b0e914f-669d-4c4f-b8c4-548eeddbe5c0,0,15,0,0,15
3b46fdf9-eeaa-422f-8dd9-559bb3c76e99,12,2,0,1,15
3b81ff9a-9550-4f90-b2ee-45bef1f212e8,0,76,0,2,78
3bd46430-358e-413a-99e2-425e8bb91109,13,2,0,10,25
3bdde101-8415-428c-9b4a-5c8f223f5397,0,15,0,0,15
3c1596f7-645e-4162-b89d-4b08affa0954,0,34,1,0,35
3c3ced63-9f37-4512-9504-1bc9f3d39d5c,0,76,0,0,76
3c805a64-2049-41fa-b454-7aa60d7bd4f3,71,3,0,0,74
3d1944a8-8bb2-466c-a46e-1d130554ef32,0,15,0,0,15
3dce10d4-19d5-410d-a778-704360377836,34,1,0,0,35
3ddab305-0ca3-41da-baa8-edc5beebaa8b,0,80,0,0,80
3decc38c-a5c9-4e4e-bc09-5a37cc259ee4,77,1,0,1,79
3e18c1e8-b918-4f77-8e36-b28ff5d2d0a7,0,21,0,0,21
3e204307-fe2f-47b0-9d44-d62037ccd4a4,70,3,0,1,74
3e35263b-0397-4fa1-b515-31b08790c3c6,0,20,0,0,20
3e5ed711-f881-40e7-b369-be05b35cbfea,0,15,0,0,15
3e6925c9-85a4-4805-b448-13f78ee38673,80,2,0,1,83
3ead5f10-a485-4286-a42d-d16cee176e00,0,77,0,0,77
3fdc4150-5805-4039-8fa9-a5de6e229bd0,77,1,0,0,78
403fe597-0575-476a-9170-a1df9778cce8,0,20,0,0,20
40a179fa-5ee4-45d0-b5fb-2ca1afe7cf12,0,19,0,0,19
40eaf82a-57c1-4536-a4b7-e342a70bc417,0,72,0,0,72
4119c62f-835a-4e3c-bb18-9821f845c66a,0,20,0,0,20
41342093-5665-409e-ab5c-4b93c4b47f90,0,34,0,0,34
41e4d077-ad91-40e6-93c1-4a9ab40b0660,0,78,0,0,78
42051efe-ee0e-4670-ad7c-be076c8117c1,0,72,0,0,72
4213c509-69e4-4aef-bddf-8fa1b487db02,1,14,0,0,15
423db8e2-7be0-47ee-b698-2a0957d27a9d,0,73,1,0,74
4267a9c9-a0c7-4c78-8536-cfffec9c6aab,12,4,0,9,25
426d0d1d-419f-4f42-9f6e-9b44a57f7739,0,21,0,0,21
42844e19-fcb8-40a0-bce9-18b9a665ad13,2,78,0,0,80
42fb6801-adef-4586-9220-0721ad4d5a7f,0,75,0,0,75
43235b16-b917-4386-bc9f-ffe8cac15ae4,1,21,0,0,22
43524212-595c-4068-bf4f-373d80ad2846,72,1,0,0,73
43a0d8a2-41f0-4505-95b8-83ae6f577fe6,0,17,1,0,18
43ddc909-d1d2-4517-91dd-dfe7f01f9d86,0,78,0,0,78
44349734-0633-40d9-8a23-9e83f317bdc8,1,19,0,0,20
4441ef84-830e-4945-bb94-121cbf151b3b,0,33,1,0,34
4489bad1-0749-475f-beaa-ffe5db7a03e5,0,74,0,2,76
44fdbc58-a3c1-4588-8473-611a50fa76f2,0,18,0,0,18
44fea536-808d-4c6a-9996-c4c8b765f7c2,77,0,0,0,77
45461f49-9efe-480f-a43e-64d59fdba3eb,0,20,0,0,20
4578f78c-2c30-4842-b82e-d78ccfa95ab9,0,74,0,0,74
45d829c3-74ad-4141-a33c-dd4dfcd3a6a1,0,19,0,0,19
45e9b82d-1955-44d7-b0b2-f8e081e7d5c8,0,76,0,0,76
464d2f31-1f80-4b85-9ae4-38e25301d38f,78,1,0,0,79
465244d6-5321-434a-9ff5-7b836f750a96,0,68,0,1,69
467159f7-8497-490a-9eba-6ac2ecdf8d56,0,34,0,0,34
46b00033-9639-4a69-bb1b-2149caaf44dc,0,71,0,1,72
46efdd1c-df53-4f37-892c-a7b9dff7810d,14,1,0,0,15
47465cf4-4a55-45cf-ae9e-5e8d5477688d,0,22,0,0,22
474b5bf8-7a4d-435c-8fa4-88f4e55f7265,0,76,0,0,76
481160b6-994d-4fe8-a312-b28c7ed7e21d,1,77,0,0,78
481a89bb-a56b-484a-bbd2-c11126acd610,79,2,0,0,81
484b8345-c2fa-4350-987b-2cc4f29acdc9,74,1,0,0,75
484f99a2-f6af-44e4-b7af-dadecd0ec609,57,5,0,8,70
485ec779-7010-4b74-80fa-c0da2114872e,0,33,0,1,34
486cb108-d1df-4c09-9321-5aef6c280db1,0,19,1,0,20
486e3536-3c99-41ed-ac0d-bd0210d00dd2,0,85,0,1,86
4880d9ea-d1a3-4d46-b8cd-c4e19af4294a,35,0,0,0,35
48bdbfb2-8042-4eb5-bc84-b0b8dace3e1b,33,2,0,0,35
48c5659f-c7cc-4a5c-85e9-0c1327ca963a,0,19,0,0,19
48e07428-aff9-4cf1-ad51-29490b85d907,0,70,0,0,70
48fb69a8-615f-4d19-bf2a-564faa750050,0,1,0,0,1
492161ce-7b09-41ba-b676-7400a7b340e3,0,20,0,0,20
49399782-6985-4018-ad1f-a14fff6f23ee,19,0,0,0,19
49423670-658f-487f-b585-c3ddd4cf7831,0,15,0,0,15
49b63b2f-17cf-41a1-9bcd-4d0440caac6a,0,21,1,0,22
4a44a084-312c-436c-a8f5-7cf395960af0,78,2,0,0,80
4a7013ef-5bc9-4830-a845-6e5ca9decd65,0,71,0,0,71
4a75ad56-87ec-4403-9191-3a5c563a5bd7,75,3,0,0,78
4aa3c5d8-9845-4c45-95e0-39f4be7fd85e,0,15,0,0,15
4aa7d1f5-a76f-4af4-8636-7074a07afd05,71,5,0,2,78
4ab4c765-25ce-4a2b-b521-da28012236d3,0,73,0,0,73
4acc31cd-e638-45f4-b459-cd07a8043277,0,15,0,0,15
4ada49b5-0493-4346-afd7-c3001a50777b,0,35,0,0,35
4ae8682a-726d-4641-b579-4ed1972b9e30,1,76,0,0,77
4afb3e11-32d6-402e-8d98-a1b994a5e7c7,1,17,0,1,19
4b7751d8-4a00-4029-8706-a5f3758df621,0,15,0,0,15
4b798a99-47dd-401f-b4ff-7480910483bd,73,1,0,0,74
4bad2675-d5e6-4b3f-88d7-8bcd18391c62,0,15,0,0,15
4bd19647-a5c8-4766-acd3-c96d65c80390,1,14,1,0,16
4bee9459-4d49-4453-a70d-1e58446856ea,0,68,0,0,68
4c2cb6c9-d832-4903-b07d-db95fcaef8c3,0,78,0,1,79
4c62c7d9-90bb-4d74-b955-3e3ee2aa0d6f,0,15,0,0,15
4c65c0b8-57e4-4180-90ad-9c15a1c45032,0,80,0,1,81
4cbb8157-7c61-4fb1-8340-98177e3d08e5,0,77,0,0,77
4cdab283-2e99-48c9-a09c-9a323b187195,72,0,0,1,73
4cf2ccf6-6acb-4c57-a389-1dcdf7dbca6f,0,15,0,0,15
4d402af3-b527-45fb-bb86-b8626430b7b8,0,77,0,0,77
4d569089-2d17-4f8b-bd9a-5e751959dee7,59,2,0,10,71
4d5a42c8-f522-4161-99ba-57b68cdb516c,0,15,0,0,15
4d7119b4-643a-4a10-ab05-2716120d0cf3,0,78,0,0,78
4d94653a-4769-4cd4-b7e5-62f662b7e8a8,0,17,0,7,24
4db34500-f560-41c3-982c-c24050ee62f9,1,74,0,0,75
4dfd342b-efe1-4d45-8a13-7a81513f877f,0,35,0,1,36
4e12bfed-3f6e-4233-9110-548f3d8138a1,14,1,0,0,15
4e1e7448-bc76-4415-a6fc-c528fbe15ffe,0,20,0,0,20
4e2b8a32-cced-487e-8466-2b708b043095,0,36,1,0,37
4e843d7c-df4a-4388-9545-992d66a33cca,0,15,0,0,15
4e92423a-0f9c-4dd3-863a-d0e0ecdcd893,1,79,0,0,80
4ef9c8f3-0a38-4fc6-bb14-ca23e8e65cc6,22,0,0,0,22
4f698775-dc38-46da-8781-89f0e138f1e5,0,20,0,1,21
4f8a73f5-e7cb-4408-9c6b-c49b9ebed8fa,0,22,0,0,22
4f984443-b8bb-4649-8c29-248fe4cf67f6,0,78,0,1,79
4ff778e8-547e-49b9-83a7-f8711154df84,0,79,0,0,79
4ffadd2a-9b83-4f9d-b4b3-f0497c611e85,0,75,0,0,75
5010419c-68c3-423f-bbfa-a06f7ae77aa2,68,1,0,0,69
5065a6ee-0b7f-4d20-b5bc-70c97ce6048c,0,20,0,0,20
506bf4ed-02de-4e86-8112-5da78ba7ec8c,0,70,0,0,70
509c288f-d211-422b-8874-0256e18cad2c,76,1,0,1,78
509d1a93-fff9-430e-94ec-c30087678368,0,21,0,0,21
50b29f21-b0a6-4987-bcf0-2be2d6268c1b,2,73,0,5,80
51200a40-8eed-434b-b488-0deec4196e4e,0,34,0,0,34
514a0643-a315-4e37-bf06-4ac7b060f270,0,74,0,0,74
514a1a05-cb4e-482b-b1fc-f7cbc2c07e2f,15,0,0,0,15
5191c573-2db0-4261-96a6-4e0a2feca2cc,0,21,0,0,21
51b8d916-1441-4f35-a290-fb164f7a5ca7,78,4,0,1,83
51e86d23-4089-44cb-934d-292fb14ba214,1,33,1,0,35
524f1f1e-2237-4618-911f-3804233862cf,0,21,0,0,21
527603bc-305c-4bb4-a566-8e214e460de3,75,1,0,0,76
52f46312-fdb4-46e8-a62b-a77d7aae791c,36,0,0,0,36
53459ad9-908f-4c1c-afa7-df13f74c897f,0,68,0,0,68
53606950-2c8c-4488-b98e-7506173e8156,0,14,0,0,14
540c2946-d2fc-4d74-a3ea-560d39c530ac,15,0,0,0,15
54339630-9cd2-440b-8f8b-7b97bc20e53d,0,73,0,1,74
5435f661-9f9b-4bd8-8982-1caa08a0b4bc,0,34,1,0,35
5487fccb-26af-47eb-9d42-9f1e2a3f6e1b,0,19,0,0,19
548e7f10-5eb3-442a-8825-e963018d2990,77,0,0,0,77
54decb4f-7363-42bf-8653-34847b88c9d0,0,33,1,0,34
54dfc6ed-3e14-46b7-aa58-30e44c92bfb4,0,73,0,0,73
5523feb4-dd95-489a-808c-0c8f92f20af8,0,34,0,1,35
55484f81-7bf1-4853-8f00-688f7623dded,0,72,0,1,73
554fcd41-a1b7-4235-9d42-75390e951955,0,72,0,0,72
55861f11-a816-4650-b774-ba1c93247198,0,75,0,0,75
559bc673-3dd9-4e03-8ce5-5f8f8c733016,0,15,0,0,15
55c8db96-f341-4625-93d3-d07138aed372,0,71,0,0,71
561330c6-9868-4350-80d9-bb8485282316,19,0,0,1,20
5640283f-e650-4c6b-a274-79d3c006f5da,75,1,0,0,76
5655d43c-5c72-477a-bf50-eee364c3b369,75,1,1,0,77
56567b41-68f2-4b58-b8df-469a66c791e4,0,20,0,0,20
5679e5ba-a6c7-48ec-b3bd-2edb8acc1cec,0,77,0,0,77
568d99e6-67e2-42fd-af01-f955f0d891ab,0,67,0,7,74
56a32f29-dc48-4f79-befe-d2fd67b9b159,0,73,0,1,74
56cbe82a-3195-42e8-a436-6f1a82686726,21,0,0,0,21
570cc0e3-6f4d-4f6a-9085-6445a36e9859,0,20,1,0,21
579e4258-c7a6-464a-bd14-fe065a50ba7f,70,2,0,0,72
57c3e506-ebee-4d6c-afc8-bba0133e6ed5,0,77,0,0,77
57de72bd-1c1f-45f2-a00e-8d8767423bdf,1,75,1,0,77
58263f72-ee41-4b83-b421-9e3a8036cb85,0,19,0,0,19
589f495d-4efb-4039-8045-1ec41831161e,72,2,0,3,77
59304800-1d13-4974-bca9-b03d2229f4b3,0,77,0,1,78
596b026b-dbd2-4f71-a6c8-d722f9454c2b,1,33,0,0,34
5a34ec18-6a3d-47a5-958a-45cffb5b6676,0,34,0,0,34
5a73968c-acbe-4465-a91e-f2a807aafba3,0,15,0,0,15
5acec5d9-cf20-48f4-892e-017816d77293,0,34,0,0,34
5ad62cd0-77fa-4844-b1c9-7a66944ad779,0,74,0,0,74
5af73265-4893-4002-bf68-2f5d0a4e3407,0,21,0,0,21
5b3832c0-204a-40ca-a2c9-b0d336c02e0d,74,0,0,1,75
5b3f242b-9267-4369-bfc5-18d75269bf82,72,1,0,0,73
5b73b387-9c6d-4067-ad54-f8f587423798,20,1,0,0,21
5baaa374-7f35-41d5-8937-456f932cecf3,73,1,0,0,74
5bf9a8e9-7a02-48f1-9ca3-d907d2909a2c,0,15,0,0,15
5bf9e3a2-5dc4-4d86-a09f-9d89d6b610f2,0,35,0,0,35
5c0eb016-0915-4b94-bb8c-c5a7b4f3c47c,0,73,0,0,73
5c4048e1-5b85-4e1f-a346-1ea9a9b9546f,0,15,0,0,15
5c64fbf5-3b08-4188-9d6f-13b0dfe5368c,2,74,0,0,76
5c8a062b-33e2-4b7d-be73-27479693f2c5,2,0,0,0,2
5cf7671f-eaaf-4f4e-acd9-ccd7f1549ce3,14,1,0,0,15
5cf8fe29-8b7e-434b-9d0e-4340183c5ff4,36,1,0,0,37
5d42993c-cdf3-49a2-8bb6-733a6aeda2fb,34,1,0,0,35
5dd9bd3b-b4a0-44ea-af9d-03aeef7e4296,0,72,0,1,73
5de6989e-944d-4bd5-be74-d010ae6316af,0,35,0,0,35
5e622c66-aaf5-44dd-83f6-4a0fa7b1d4c5,0,76,0,0,76
5e8b274c-67b3-4568-a0a1-8f3acb7184aa,0,15,0,0,15
5e9d3a45-6b6f-40be-8e4d-6f2f1d39f4e8,0,20,0,0,20
5eb73bc8-b3a4-4669-a142-c830287bfc2a,19,1,0,0,20
5ec4c8f8-355e-4357-845d-68e6683bb365,55,8,0,13,76
5f4a3ae9-0602-40c0-8045-ab907bfd0337,0,67,0,3,70
5ffacb3d-ead4-40ef-a677-fccb70bfa365,0,15,0,0,15
6029ba10-f22f-4839-9a2a-e0bd0caf57c4,0,21,0,0,21
60873059-a590-4d44-8805-a779702e29de,0,33,1,0,34
612c8d24-09d7-4582-99c8-741a4c5a8335,0,19,0,0,19
614a9faf-ea70-4302-8a29-fc3b20bf000e,0,37,0,0,37
615124c1-8687-4ebd-be66-bd526f8e56af,0,35,0,0,35
6193c661-6fe3-4af9-9454-db09160cde6f,0,29,0,5,34
61afc382-ebd5-43ae-aab2-8d9690ee1052,14,1,0,0,15
61b114a6-4465-48ba-b644-8a3971382a8b,0,76,0,0,76
61e6b604-8021-4f23-96fe-39002f901c55,70,3,1,0,74
61e8e9be-193a-4304-b36a-046f5157d399,74,0,0,2,76
61ee5f0a-ac22-4e97-a7c1-2b34afd1dbaa,17,2,0,0,19
61eee60f-e4f9-456e-8327-37c37142b5cb,0,31,1,5,37
61fb7e01-1ac0-4ddf-a5b4-27a146905252,0,20,0,0,20
61fbf697-8594-4b63-84cf-e78234703f2d,20,1,0,1,22
6235fe31-a4be-4307-bc3f-248c58c7d1a7,1,30,0,8,39
62c0a115-5ef9-4e10-9827-554027f7d915,74,0,0,1,75
62e2d0cd-36ca-4d0e-84fc-2a64ab659808,21,1,0,0,22
6303c900-6c81-4f81-a06a-cc13aaf6e329,0,22,0,0,22
634d16b3-7c37-440c-b033-8f58e9a98cfa,0,72,0,0,72
636b5d20-545a-4936-8dff-5d152ecac361,0,74,0,0,74
636d620f-6736-480d-b5b8-3fca387dd4e2,71,0,0,0,71
6374ed2e-e07f-447c-ba00-fc139996a5ac,33,1,0,0,34
6376ca33-74ef-4dc3-9511-f895d5a0dec8,75,0,0,0,75
638c70ce-6eff-4834-96eb-0f28ad977588,0,75,0,0,75
63aa0405-18ea-4b38-b05b-c1bf3bf0f142,0,19,0,0,19
63c6eb91-8f08-4150-9319-89de2391f778,0,75,0,0,75
646fda98-e119-4435-ab6a-a919b218b8af,18,1,0,0,19
651e4f67-6fb3-4d90-bf27-e59f9b341b50,0,78,0,0,78
651f9c76-62ae-4620-abad-a86b7d0bc33e,0,15,0,0,15
6541f391-b348-4591-a261-f5ed628e7e03,37,0,0,0,37
6577adad-f17f-47d4-b69a-a1519e36fc4b,16,0,0,0,16
6584b02e-b750-4727-be78-d17780b5e042,0,77,1,0,78
65a53c58-e44a-4ff9-bd58-07765c338820,0,77,0,1,78
65debd30-e099-4df8-9320-ae6abd48ea16,0,66,1,0,67
663d12fe-ed68-4052-af8e-fbf99186b488,6,9,0,3,18
66a90126-b8b6-497c-8891-b24203a6589d,0,33,1,0,34
66b1dd13-d6c7-49eb-9731-73a20a89180f,71,0,0,0,71
66b5be30-9ded-4389-a721-4d36303342dd,34,1,0,0,35
66c2342d-cc10-493b-b937-468d7bbb5a91,0,72,0,0,72
66ea26dc-3d4d-4c1c-aa73-0d4141f132ce,0,15,0,0,15
6708cd85-0c00-46fd-8109-cd3fae02545f,0,70,0,0,70
672226f9-9ac0-40b5-a6d9-2db1b09fcbb7,0,72,0,1,73
6736be06-ae65-4776-9820-36727caa6776,0,68,0,1,69
676a6efd-f5b8-42e7-a9c2-d185cf12d579,2,12,0,4,18
6778cd51-328c-4b2a-9aea-5006f2f2fb49,72,1,0,0,73
678de9c3-7e26-40a9-8c6e-564b7184bad8,74,1,0,1,76
67b1112d-2266-44b2-bbcb-ab1e0883ce72,0,33,1,0,34
67e460a6-e94f-47d6-a9c2-ac47f4f82443,77,0,0,0,77
67ef3e21-d2e4-4901-9119-72407e047233,0,36,0,0,36
67f86702-8f70-4a29-bdb4-3d8951329d80,1,14,0,0,15
68112f5f-4551-456f-b664-348bab0882d3,0,15,0,0,15
6817d37a-d67d-4593-9b84-ae6a4a136f1d,14,1,0,0,15
6820c8a0-4903-4e4a-b048-cbcdc9e66f8a,21,0,0,0,21
682c5cf9-3d44-43f9-8203-a6dd792a6c1e,0,21,0,0,21
689f0403-7ebd-4829-ac10-a5d7e377715b,75,0,0,2,77
69308ac4-424c-4dd7-b196-c31b942c2c4e,74,0,0,2,76
693136f0-7886-4cea-b912-ae7d8cc41007,0,34,0,0,34
696743fe-7836-42af-b101-2a63816188c4,67,1,0,0,68
69c59144-6edd-4d3e-abb3-ad3c40eb0a18,0,35,0,0,35
69f73428-0660-4b6d-8389-7bcef4b3c272,0,79,0,0,79
6a0bdb4e-8fe7-4686-9d61-9b5b1b7238ca,0,15,0,0,15
6a12dc7f-bf65-47c1-8312-f809a5b0d156,0,19,0,0,19
6a505ea4-70aa-4398-840f-5d068afd22a2,0,76,0,0,76
6a85a542-2415-480c-9e35-684a6abd3a25,0,72,0,0,72
6a96c3e2-c057-4bff-8d51-9df52706a58f,0,82,0,0,82
6ad5ac26-0020-4479-afb5-c0db9212de09,0,34,1,0,35
6ae9c5c1-7968-4e69-8e84-9bdc5de3bfc1,1,70,0,0,71
6b099869-883b-43d0-ae2c-22599ff78f64,0,35,0,0,35
6b49844f-f71d-46f9-a704-c639c2d8ec0e,0,35,0,0,35
6b6aad6b-b1fd-4c33-97e1-97b2b727be9a,0,80,0,0,80
6cce0d22-380d-4220-bee9-abe59a61f1b2,0,20,0,0,20
6ce6e34c-e400-4b2a-b19b-f17f29c58741,0,21,0,0,21
6d90c0e5-a6f3-4f2c-bf9a-421eb22469dd,0,13,0,2,15
6dc45c40-b45a-427d-a79c-4334f35cf737,0,15,0,0,15
6dda191c-7471-409d-a254-4f229ef684c6,0,67,0,0,67
6eeb6625-0cea-45f5-92aa-2d975808f27d,0,21,0,0,21
6f17dabd-dfef-4066-ae54-33ee54474ba8,0,73,0,0,73
6fb6f7f3-e719-4969-bbd1-e827408bf66e,0,76,1,0,77
6fe0290b-e16c-48f2-aae4-0fec2e726612,0,69,0,0,69
6ffbe235-2164-4d2c-9bf3-95a0df477f01,0,35,0,0,35
7017a65c-a1e6-4045-a9d6-676564db115a,71,0,0,3,74
7089927b-a82f-4e8e-885c-e1e02e832af6,19,0,0,2,21
708dc57b-4629-4942-b610-fe05c52bb795,77,2,0,1,80
715cbcaa-1a45-4ee6-b516-eb7e01842e45,0,74,0,0,74
715ce251-4e17-40e6-9b41-73d38cd7904d,0,72,0,0,72
71edbd59-3b41-4bb0-9d07-0e2700bd8836,0,35,0,0,35
71eef1bd-b792-4798-afca-643690e45bd9,76,1,0,0,77
71f41379-957b-4ae6-999f-49cb0fb9fe88,0,76,0,0,76
71f869aa-f9a8-4be4-b6f2-a3151057702c,0,15,0,0,15
724635db-7334-4185-a693-1e6c77a314e9,20,0,0,0,20
725dc315-d64c-4a66-8c9a-6a8e36c6170f,75,2,0,0,77
7261fed1-a7db-45aa-ac17-4d33d8b7c7b6,21,0,0,0,21
72b82ec8-23c2-4849-a66f-a4d49e0a6203,14,1,0,0,15
7325e2f5-c02d-4e07-b953-2c4759c65951,0,73,0,0,73
73262390-0df5-4436-8347-cb8546388a8f,0,74,0,0,74
7338a938-d216-4a0d-957f-e79ddbae74df,71,3,0,0,74
73dac980-b3f1-4e5e-88a8-37c7e9d2f3cd,76,1,0,0,77
7411ca22-05fa-4624-bd29-4cc3f5b2b260,0,35,1,0,36
74124c44-da39-4f6a-8b0b-3f96754af670,0,74,0,0,74
74653615-32e9-49d8-968c-b456d5371ebc,0,69,0,1,70
74679ab9-0d96-43cc-b84f-bbd825e93da0,0,35,1,0,36
74c8931f-8a8d-48a8-b9f8-2d4f2aec32a0,74,2,0,0,76
74ec2211-e0dd-4b18-ba7a-74082f985c84,1,15,1,7,24
74fe62b2-36f8-4128-8f77-d3025ba6157e,0,78,0,1,79
750a8b92-6d82-4182-ac4b-cffe975fca68,78,1,0,0,79
750ee08f-80c1-4e4c-a177-23beec2da6a9,0,34,0,0,34
75202701-7c72-4eff-aeda-a74106afb3bb,71,3,0,0,74
75545a1d-6bd3-4520-bafb-39fb94ee8d89,0,15,0,0,15
7593c51f-f12c-4b65-8299-79c1df68a2ee,30,1,0,4,35
761b3cd3-b7f8-44dc-8dde-697e46c181ab,18,1,0,0,19
766cc099-ff5a-4149-b183-1a1423fba157,0,73,0,2,75
767250a1-8dda-4c7c-b17c-8e0de6c731f2,75,1,0,0,76
769e0c50-13d6-436e-ae64-a62ff4ed50da,22,0,0,0,22
76b0bb73-d248-4a5b-b2ea-23c7a7569dd7,0,73,0,0,73
76b81486-77e4-42e2-a47a-da6035042a98,1,20,0,0,21
76c66475-c9ad-4934-adde-9070bc9d8aed,1,73,0,2,76
76f849a8-2349-4c87-8e5c-beb24d5ec8e6,0,15,0,0,15
7707fb8f-bf74-48b7-b73b-55fc551e92c1,0,36,0,0,36
770cea36-d62b-412a-bdd1-4e9364f54830,0,71,0,1,72
7719aed7-82fa-4aef-af8a-85ce37610ffd,0,15,0,0,15
77524d42-6c96-40f9-ae5d-cbd8900d6c61,0,73,0,0,73
77703884-26c0-4da7-9144-636f933ed022,73,2,0,0,75
7792da6d-e9cb-4489-a7f7-01fbc3821d7b,0,71,1,1,73
779c0f24-a828-4972-bdc0-4887c5daac8b,0,73,0,1,74
77c9d15f-98c7-45b4-89a8-6f21ab07157d,0,71,1,0,72
78372dbe-05ee-48fa-b3d9-c936506151a6,0,74,0,2,76
78d92074-f26d-42de-8ea7-a36b12a244af,0,35,0,0,35
793dbc31-1c56-4504-883d-dec796e2f0c5,1,74,0,0,75
7970cfa3-54dd-407a-b7c0-6401bcccc41b,0,35,0,0,35
79897675-ed28-438a-bb54-e3a8bed579a6,0,68,1,0,69
79924f60-e9dc-46b2-aba3-5fbcb68effb1,0,20,0,0,20
79ac228a-d986-40c5-870a-b3eed111d428,0,32,0,4,36
7a23bc89-2990-49b5-acef-0ec35a05ea4f,0,35,0,0,35
7a6d52ea-a844-4198-a528-b8037c6d1281,0,20,0,0,20
7af6861f-4062-4c12-8351-c4845f0d7a86,0,15,0,0,15
7b17e1f5-c249-43f9-97ac-7182315eadb1,0,37,0,0,37
7b1cf081-4e89-4fbd-b919-38ff0f21f35c,0,14,0,1,15
7b387580-1225-402f-8d19-e76a90831cc1,14,1,0,0,15
7b4736ff-605b-45fd-8569-6cdbaddefba2,0,34,0,0,34
7b800dc6-7ad4-4a63-836f-6d9c0f3caf2a,0,83,0,0,83
7bbbe3f0-d2ab-4bfc-b0a6-316efcbe8a50,75,1,1,0,77
7bc6a9e4-5bcc-4c59-9828-84732d165b2e,0,36,0,0,36
7bf44e37-b4f8-4e3e-b8f3-d69057e71489,0,34,0,0,34
7c393efb-1c08-41b1-afd9-1da853e477cc,0,78,0,0,78
7c5ab6cf-daad-413a-b2bc-cd311dfb94c4,0,20,0,0,20
7c84746d-ddc8-445b-936d-e3eef2ba5568,0,21,0,0,21
7cba2a51-e8f8-4739-828b-ae6e5cc6ad8a,0,75,0,1,76
7d029e18-aff7-498d-a393-496b49805419,0,74,0,0,74
7d49842b-f67b-410b-9666-28a232f17088,0,20,0,0,20
7d6f1cf7-b865-4efd-a84b-a57044d6719f,0,72,0,0,72
7d7a30d8-729b-4673-94cb-ef6d9e728291,12,0,0,2,14
7da1b23f-c310-4ace-a751-ad4f35510859,75,1,0,2,78
7db66b25-0ecc-487d-9e39-8973c65e2b03,0,15,0,0,15
7df1817e-ff99-4429-ac3a-16f7ad83ab12,1,67,0,4,72
7e632a66-b4a1-47e8-99b0-88cdb1821f8a,34,0,0,0,34
7ec545d6-023f-481b-aeb5-41e513483ee7,0,20,0,0,20
7f3781f1-7498-4f4f-b8d8-c2cb8c6a3ff8,84,0,0,1,85
7f40e896-bd3b-441e-8fd5-4f61d7224c31,0,70,0,0,70
7f6e8710-def6-453d-912c-b8bb9347a227,20,0,0,0,20
7f7dcec5-8695-4b06-809f-ff51d98877d8,0,77,0,0,77
7fd98d23-6537-447c-b3e2-a369d424d5f8,0,67,1,2,70
7fe9e2bc-8ebe-4dd9-9eeb-5a73263feaf2,34,1,0,0,35
7ffdb928-1106-496b-8d8d-cca1a5266e8e,13,2,0,0,15
809a2a10-d0c8-4af6-9d90-fb76b9ef81d0,0,69,0,0,69
80d752fa-bbe3-4411-b924-4c62d1d88f74,20,0,0,0,20
80e7df57-139f-4459-a90d-59361c30b4ff,0,36,0,0,36
80f5d89f-6f79-4c49-9e15-6bbd526d1912,0,32,0,7,39
81d59553-f217-446a-97e9-cca95c88e353,0,76,0,0,76
820b2bb6-9f45-4ef5-b53d-8edd6bc1c99c,1,74,0,0,75
8276b561-cb04-4c9c-bcd6-a0d7bbd44514,0,36,0,0,36
82848810-e5ed-4e01-8b62-96f9d640de21,0,18,1,1,20
82ea1d8e-cfa2-4a17-901f-c187abebc3cb,0,74,0,0,74
831d1b88-047f-4073-9dde-405a24a2ab37,1,14,0,0,15
83333279-b6f1-4052-bb61-7441fe52f06a,0,73,0,1,74
8364c43c-2816-49c9-9a93-1b27e31a5f01,0,77,0,1,78
8397fe68-e3f8-4f6a-bf96-2fd74859b9b7,0,74,0,0,74
83bb842f-324e-4643-89c6-840b87259f32,0,86,1,0,87
83c13d58-ea7d-42c2-bd37-ad193c9ca00b,70,1,0,1,72
8403926d-0bf7-43ec-96ea-36104a35160b,0,20,0,0,20
8434ce4d-7e35-41ce-85c6-78f3bb5ee64a,0,20,0,0,20
84773572-d4b2-4d05-ac22-54de551064d6,34,1,0,0,35
84ae2d69-aaac-40f8-93cb-cbdaaab05afa,0,83,0,2,85
84bebaf9-1fc0-4e6a-9c96-61616dc00dd0,0,75,0,0,75
8511e078-6257-4dc9-94e2-14494d874775,1,78,1,0,80
853eb65f-91dc-4488-945c-88943e31b5de,1,33,1,0,35
854b3bca-caea-4522-b49a-cd1fda314c1b,0,15,0,0,15
85612d16-0f1c-43a4-8a90-f5047c7038e4,0,15,0,0,15
85976fc5-f307-40ee-85af-e64e779cec49,71,0,0,0,71
85be6f9b-e8eb-4be9-bc1a-4140080b7855,0,22,0,0,22
85dc726b-82a7-48bd-b23a-ed3bb428d83d,72,0,0,0,72
85e4c727-ae2c-430f-bcf6-ff59ea8fd797,0,20,0,0,20
8622071c-85eb-461a-ad93-8b42495c9564,0,15,0,0,15
862f241c-50a7-4500-a2ff-c358fd220bdc,20,1,0,3,24
86346f37-da9d-4fab-9b2e-4c942eb56aa9,0,82,0,0,82
86f9c67e-3330-4f21-b009-04e25931822a,0,22,0,0,22
86ff282f-0de9-4e04-a5e8-92acd8b2c49c,0,80,0,0,80
873c0f5f-c92e-4be3-b5a3-5607b0ac1680,0,32,0,3,35
875120ee-879e-4a5f-a67b-f0c619a528c5,1,15,0,2,18
8757f7ba-6d65-445a-b162-08017ba7654a,0,75,0,0,75
8760270d-cbcc-4c5e-8a2d-df3d7c6c84cb,0,80,0,2,82
8777f6e1-d287-4614-9182-32e1af0388c6,0,68,0,2,70
87a67837-0ac2-4b00-bdab-3574f8cffd27,0,35,0,0,35
881d715c-2318-49ce-a053-322192672283,0,20,0,0,20
884e7bd4-8142-4b94-ad3d-0195e5bb7fdd,0,20,0,0,20
8869fbe7-8a02-45ba-a7b1-1222a0ed8403,0,70,0,0,70
89864bbf-b491-41c3-b1fa-bd8b9d0e6bc9,0,33,1,0,34
898c9849-e98e-40a1-82ae-a5a6665c1b5d,71,1,0,1,73
8995c638-7b64-47ff-899f-29e8fa1555a9,79,0,0,0,79
89afc080-cd2e-4a03-be38-065051439a23,1,15,0,8,24
89b5de98-c84e-426b-b95d-6a9d8eed870a,0,15,0,0,15
89bf3cbb-185e-4df8-a2fc-eae689bb567d,0,69,0,1,70
89f38eb6-dbb7-4277-975c-dc7d98a82b86,33,1,0,1,35
89f4232b-c596-4e66-b599-b5a753fe4f82,0,82,0,0,82
89f6c9cd-904f-449c-9f7f-3f4c73badfc5,0,70,0,2,72
8a08c2ef-8c16-44aa-9db5-7b06d8b85437,0,19,0,0,19
8a62d928-8fde-4cd5-95a3-bab4c01b6e2a,75,0,0,0,75
8a7d21e4-45c5-4183-a0f3-a7457116a2d1,0,74,0,0,74
8aa2b88a-1beb-456f-b946-397120756a6e,73,3,0,0,76
8ab6a9ba-4ba2-4695-ba20-4064a839c0d7,0,73,0,1,74
8af26c3b-c200-427d-9eae-fa32236aad5c,33,0,0,1,34
8af464cc-6c04-4e8a-b2dd-2189927a0879,0,34,0,1,35
8b0c4c98-e88e-4887-b231-aec1a7bb63aa,0,74,0,0,74
8b133dc8-6326-459f-9033-24eeab5a14bb,0,35,1,0,36
8b15a4ac-ed7f-4d73-af50-6467b13482e9,0,15,0,0,15
8b1b407d-e95a-48c7-84fc-19a5da7878fb,76,2,0,0,78
8b314ba8-5889-4523-97bd-4990a83ec577,0,69,0,2,71
8b3813ba-179c-4eba-8b22-3573ec11050f,0,29,0,10,39
8b42b57e-114b-4d26-a3b8-35c119185fcd,0,73,0,0,73
8bab4a92-5f54-4e64-bf0d-41c4cc9d97cb,0,21,0,0,21
8bbe9cba-7af9-4f6e-9e29-d2d48c26c9e6,78,1,0,0,79
8bc6f33c-ddd9-4286-bca3-03858e547b69,20,0,0,0,20
8be5abce-a899-446f-8b5e-59f9f519ee9b,0,34,0,0,34
8beb14f9-fd86-46aa-923c-3ba24a7403ac,1,74,0,0,75
8c1750f3-4f56-4932-bd7b-41f91f65f13e,61,2,0,15,78
8c359084-deb9-4b9e-aea2-bdc626d97d83,0,20,0,0,20
8c7c5aa2-44b0-4a2e-a925-f6f69b1aa85a,0,15,0,0,15
8c8f83f8-5e64-49f4-b684-a64714e87371,71,2,0,0,73
8ca982a7-9def-41e7-92b9-c81a650032ed,0,80,0,1,81
8cc4409c-3fcb-494e-a270-57cf95d6673f,0,70,0,0,70
8cd520ac-9216-4f8e-a425-18ec967233b5,0,77,0,0,77
8d0fe78e-0c69-44f1-abaa-8aa498f926ec,68,2,0,0,70
8d141a19-4cc5-47b9-b86b-45c4ce073244,0,70,0,0,70
8d2dba2b-6881-47a1-8fec-562179e686a2,0,71,0,0,71
8d472b5f-03af-49ca-aeb2-ff7be333a821,35,0,0,0,35
8d593d61-55bb-4b13-aae7-fe6e9040479d,0,77,0,0,77
8d7392b0-0401-4ea2-bac7-4af44cb503ab,0,73,0,1,74
8dc8feb5-ffd6-444a-9744-cd4429c1795c,1,75,0,1,77
8dd7c57c-6459-46f9-b016-c01900751b75,0,79,0,0,79
8deac079-4631-4721-a7ec-4337f9d891e8,22,0,0,0,22
8e03ecad-f867-4dff-981e-c0c25b4ffe90,0,14,0,0,14
8e4c4797-e501-4562-9465-25c62936b4c4,72,0,1,0,73
8ee9f615-38be-42b7-a183-06e98dab023b,0,15,0,0,15
8f2d10a2-91bf-4286-b12b-e0ff85b6f472,0,80,0,1,81
8f6d3f0c-8b1f-4e2b-a580-ff517719c114,0,19,0,0,19
8f796b06-116d-404e-a0c8-bbfd53d90edb,0,82,0,0,82
8f95c9e7-b3ce-418d-8bf4-190c66a2c421,0,72,0,0,72
906518ed-c00d-4c3e-b30a-aa33c5ed6d6c,0,68,0,0,68
90897288-cc04-4c28-842e-7add91715738,0,73,0,1,74
913d566f-5bc4-4c72-9da5-070656890ea9,0,21,0,0,21
915128a8-edfc-4e37-b7b8-0a465033196d,1,14,0,2,17
917974fa-fe46-479d-b136-825cf3431f8c,0,13,0,1,14
91996363-564b-4b90-bece-bc93ae413949,0,63,0,9,72
91a6e2cd-75bc-4836-8a2e-e19b184842c6,14,1,0,0,15
91ce5e62-6f16-4dfa-9c91-0097a9742c4f,0,20,0,0,20
91e078e5-6e0f-4a81-b8a5-b479979534bf,0,23,0,0,23
91eeda1b-4272-43e3-8ddf-e7b6b3693d2e,0,15,0,0,15
91f8e589-bbe3-4cd1-83cf-fba928f286d4,75,1,0,0,76
9299e70c-4aa3-49c0-8cba-51303cfedd36,0,18,1,0,19
92a7f023-a771-49fa-bbd0-d82caa461089,0,15,0,0,15
92d4af06-714d-4347-979a-135533be322f,20,0,0,1,21
93104ebb-07ae-4041-9534-893982d1c7b6,0,36,0,0,36
9315085b-c399-40c5-a5d8-f5dc1e152c3e,0,35,0,0,35
9342a9c8-bfcb-400d-9e10-3d039537be5e,0,70,0,0,70
93a8e817-0312-47c6-9147-ffde774b883d,21,0,0,0,21
93bdd390-fab0-419c-a30b-5958fea5de21,0,34,0,0,34
94299fba-b305-423d-a6c3-1c7f75e63222,0,21,0,0,21
9469d42e-b795-4275-8ef6-53e36fb8cb3f,70,3,0,0,73
9490e688-6578-4a6b-9ecb-949da9611df7,72,3,0,0,75
94a2de3c-ba01-434c-9915-d861493c4662,0,72,0,0,72
94b6f276-4657-4ac5-9345-1b9774bdc99e,0,33,1,0,34
94c67f1f-5d80-488c-b963-abb89e0c7e32,0,71,0,1,72
94d95897-e50d-437c-85c5-9b01ead07a2e,0,33,0,2,35
95052a44-d402-43d5-a311-483afca5674f,0,19,0,1,20
9505894c-676b-4114-bec2-2f5f92d0bfc5,0,73,0,0,73
95415bba-6ab9-423f-b717-479672164cda,0,35,0,0,35
9564e93b-98c4-44b9-914c-0f16be0fec72,0,70,0,0,70
95a0a7ad-14fe-449c-93a9-83f32713ef16,0,36,1,0,37
95c421a9-5a53-4720-a059-2e929af8f136,14,1,0,0,15
95c9b684-a15c-4169-b805-e68a8ea488af,0,21,0,0,21
95ced62e-59e0-4159-a1b0-9b2b3a0dc873,0,20,0,0,20
95f9043a-bb9b-4724-b855-dcc123f99645,68,1,0,0,69
97ba6c0c-9b1c-4389-a5a3-c7a6da83491e,0,34,0,0,34
97e5d8cb-1676-4869-9d3d-7c84657929dd,0,35,0,0,35
980e3a46-b359-4f22-a34e-c6786e5c4890,1,70,0,0,71
98466111-ac0f-4b61-93f2-4d5b7245e5c4,0,20,0,0,20
98776c26-8349-4716-9054-b676835e7313,33,1,0,0,34
98e8e4d9-f7d4-42b8-a738-16884cccae7d,0,20,0,0,20
98fddd9c-ca64-4e56-9622-f43d2e18f2e8,15,0,0,0,15
9988e0b1-2cc5-468e-987f-71f71834496d,0,34,0,0,34
99f5142c-f989-4987-b307-71deb2ec8c5b,0,35,0,0,35
9a10f4f6-03cc-4eef-b9fe-7cc7c5629fe5,66,1,0,0,67
9a325a73-0f25-4be0-8bfa-e0c495b6f2c5,77,1,0,0,78
9a36f89e-2430-46fc-8929-4a8401691286,0,72,1,1,74
9a504719-a6ef-45c1-af88-8684f48cb354,0,15,0,0,15
9a6e507c-2c13-4e62-9a57-2a5a232e6678,67,1,0,1,69
9aa55212-f8fd-41e1-90b4-d8e97bdee8ed,0,15,0,0,15
9aed8c2a-3873-4923-abf7-f9e17d5017bf,88,0,0,1,89
9b0fc79f-e927-43c4-b9b0-ec36d38935cf,0,73,0,0,73
9b228ac6-2405-472f-9351-960be536067b,0,79,0,0,79
9b6d43ad-c2d7-4aa5-9ccd-39f97288c439,0,75,0,0,75
9b8c3442-1a77-46ef-96d0-c43bed6f6007,0,36,0,0,36
9b9a9e26-6622-4e3d-8820-44497471a151,72,1,0,0,73
9babf5cc-4030-43a7-8347-4d147346bebf,1,14,0,3,18
9bba9ece-5f93-441c-81ff-d98b86b4bd1f,0,73,0,1,74
9bdb1821-bdfc-4c52-83d7-035ae85aee65,0,15,0,0,15
9c85901a-18bc-40f7-8423-71f3e1411b2a,0,75,0,1,76
9cb1b3a1-8db2-4005-97c3-76d8a4dc45c3,0,36,0,0,36
9cba04b1-6f1e-428e-81b4-2892e4f52d3a,82,1,0,1,84
9d45abd1-68da-4f2f-933e-76f0102a9b6b,0,73,0,1,74
9d4de57b-1138-406f-9200-a4358911366e,0,15,0,0,15
9d5829df-c496-4379-9eca-24e3f6fedfdc,0,21,0,0,21
9d7078ec-2a14-4c94-8cb9-94d11959de83,0,15,0,0,15
9d75e919-ea9f-46f8-ba93-a502c5c8889c,34,1,0,0,35
9d84b318-79ed-445b-bd40-86822d8f81e3,0,81,0,0,81
9da81ad6-1bc2-4c12-990b-cb4147333da4,17,1,0,1,19
9dc473aa-264a-4bb6-b6c9-b32a572bf0df,0,36,0,0,36
9e0b1dd0-623e-45c7-b0ec-2b5d9b6c1918,0,37,0,0,37
9e2fb860-850f-4362-9468-c9858bd3049a,0,20,0,0,20
9e787531-1486-485f-a45c-150eff74360f,0,72,0,0,72
9ed8f9f2-8899-49b1-8bfa-051c94a54eb7,0,14,0,0,14
9f14568d-9dc2-4492-a30e-9e049c143295,0,19,0,0,19
9f914afc-e9a1-4f1d-aece-6fd1a7e89a0a,0,74,0,1,75
9fec1787-624d-4b11-a738-f4ce117e13e3,0,80,0,0,80
a0b5eb09-6515-467f-a0a3-3fbf26ef8b63,0,21,0,0,21
a0c64aaf-d96e-428c-ba47-40899f64cc5f,73,0,0,0,73
a0d09ab6-6229-4ac9-a822-23b19d194c0f,0,72,0,0,72
a1163a22-f336-40c8-9ac3-3f4101196e1c,0,15,0,0,15
a12df9f9-57e8-4544-b0d7-77ce8497dca8,77,0,0,0,77
a12f2b4a-1c75-4b3c-9671-814baef37f78,1,72,0,0,73
a142f806-97b2-4e9c-926a-41cbf894aac9,0,14,0,1,15
a1c60574-50c2-4c9c-9e0a-3ab6c7d5352d,0,15,0,0,15
a21986c7-4fb7-4363-bfe0-066bc197d341,0,20,0,0,20
a2daa008-28da-4d0c-87aa-dc2df5e03ed2,0,72,0,0,72
a2f4470d-0277-4b61-8201-1894b14a7bec,22,0,0,0,22
a30851dc-c397-445c-bcb6-3c3e28c33fa8,0,75,0,0,75
a3124825-a475-4e5b-b857-d39894eb0b76,14,1,0,0,15
a35856d7-0aef-4f02-9027-56b4df1b52cc,0,15,0,0,15
a36f1491-5c13-4259-a671-126e8c81be37,0,35,0,0,35
a3878655-a1a7-4f44-9f13-2c5952ecae45,0,15,0,0,15
a3bb0d9d-9743-4a2b-853d-16eb0e90f0a0,31,3,0,0,34
a3e4fb82-2435-4e12-a595-394a7cea21ba,0,15,0,0,15
a4489dc5-878a-4ca9-ba5e-f159dde24341,20,1,0,0,21
a4592b0c-6ec2-4e08-b3d0-47e981472bae,1,73,0,0,74
a485ae8b-a39f-4354-afac-5ccc2221041b,0,20,0,0,20
a492d475-f69c-4f15-878c-dd1a4a450985,0,20,0,0,20
a4e2e324-604a-4b21-a8e4-44ca66a5c0c1,22,0,0,0,22
a4f3ca9d-267e-42e6-9e8d-e32f198f463b,0,15,0,0,15
a4f50182-d40c-4b1b-92c6-d9a2f126d9ab,0,73,0,0,73
a4fbf875-fd2e-42bf-a02e-757246b50f10,0,74,0,0,74
a50a275a-302c-44f8-9585-a53833b23e7d,0,73,0,1,74
a565152e-b57f-4b79-b19f-9490ea77dd18,0,75,0,0,75
a5746720-c5ad-4ebf-8e43-4a1862ef272e,0,34,0,0,34
a590aa6e-215e-473d-80af-f0f048ac109b,76,1,0,0,77
a5b57f38-c330-4656-a874-4c9fd55d2ad2,0,15,0,0,15
a5c9db5a-f00a-4dc2-a249-88b3e4f2114d,68,1,0,0,69
a6756d44-f136-45b0-b461-e9bee80fdb90,0,72,0,0,72
a6882bc8-9c5f-46f7-8c7e-fc9d3a038f49,2,79,0,0,81
a6db9570-0007-4b5c-9620-ecb33d28e846,0,74,0,0,74
a6e4353c-f234-47d1-a527-8f39f00da202,0,14,0,4,18
a7cf25d1-84af-4b46-828d-3f29fa632ff1,0,19,0,0,19
a7e26e91-658f-45e5-8019-237acb507928,74,2,0,0,76
a7f0a4e6-ce12-4263-ac2a-8ab83e9739d3,0,71,0,0,71
a81aae54-477e-433c-b61a-2e7737f2fbab,72,2,0,4,78
a83c775e-ef79-497f-8a7d-be3edaae6907,0,15,0,0,15
a89f6a6c-ff57-497f-bafc-73baa555b162,0,76,0,1,77
a8a9cafc-53ae-49ef-b6db-e2599b85b3e7,32,4,0,0,36
a90a4ae3-c9c3-42ac-8d43-ca2180793db4,0,14,0,0,14
a90d68cc-af1a-4fe5-9af7-09d60a75ec57,1,69,0,0,70
a94952c5-d69c-45af-b8b3-c45d15e155d5,0,71,0,0,71
a9752ab3-c4a5-41e2-b9db-f6f3d90a61c8,19,1,0,0,20
a9d203b3-10f7-41e5-b0f2-94afaaa3bf41,0,74,0,0,74
a9e9e4f0-50db-46ab-948f-548eb9eb2455,0,72,0,0,72
aa2f5af9-86c6-4625-83f5-9a4d4957bfbf,0,14,0,1,15
aa3c1dfd-9425-4262-abe6-07f7673291a3,0,34,0,0,34
aa927675-7c05-49cc-b0c9-5788f54a4afa,0,72,0,0,72
aae6d2ef-0615-4e6b-8de8-9c1fa4212115,0,71,1,0,72
aafbb86d-43f3-4e08-a45e-a7e3ce48b930,0,76,0,1,77
ab241e1f-f4ca-4b68-8590-1ccdef35f6ae,70,2,0,0,72
ab908e48-6271-4c0c-9be3-010ea1f5109d,0,76,1,0,77
abd16787-097a-42fc-9205-49f7c6ad0fa3,0,20,0,0,20
ac0af147-f8fc-46aa-89ff-efb649e07172,0,35,0,0,35
ac9dd6e0-d810-4bd7-8176-f1c94fd56727,0,15,0,0,15
aca29423-e8c5-4cb6-aec4-82e161a71f94,0,74,0,0,74
accf5f37-a2f4-4f0f-83f9-b594dcd88ddb,0,15,0,0,15
acda652e-e45a-4e5d-8a58-be92701d697f,0,35,0,0,35
ad1404e4-6285-4291-a433-6f686c2fea26,0,72,0,0,72
ad19697f-e2ec-4b5d-9e68-dcee6d9b0c0a,0,34,0,0,34
ad76754d-647b-4577-8069-f1a142706264,73,1,0,1,75
ada53ecf-bf42-40d5-98b9-80ed2f3934ad,0,13,0,1,14
adeb6afa-efc8-49b4-81ef-75d5166609df,0,36,0,0,36
ae283f72-61fd-442e-b36a-2d06359032df,0,15,0,0,15
ae9d1189-fc29-4a45-9685-d0570bcdb1ed,0,15,0,0,15
aec63294-7bae-4666-91f5-5a570625244a,0,15,0,0,15
aee5015b-a755-400d-93d9-b0cb1e049834,76,0,0,0,76
af2248ae-b73a-4dcc-9bd1-9f412d2111df,1,73,0,0,74
af2dfa5a-92c4-40ab-957a-e35e3c0e098e,36,0,0,0,36
af48a89f-343d-48e4-b98a-f4e1cd61fa79,33,1,0,1,35
af8c7e14-c197-40a2-9e14-7532cfbfd427,0,15,0,0,15
afd1b17c-a54f-4d55-8f55-b0ed644781f3,0,75,0,1,76
aff356e2-41ea-43a5-a537-690fdfc563d6,0,35,0,0,35
aff93f2e-fb77-4d7f-b618-7fa1851005b5,0,21,0,0,21
b08de286-5158-4c6d-98a9-7395257803e9,0,15,0,0,15
b09f70f8-d625-467c-91ad-203e2bece926,0,19,0,0,19
b0d68074-2675-4434-9a85-4cf3831e1502,0,15,0,0,15
b0e31944-e435-45b8-80a3-0fa24b15965a,72,0,0,0,72
b10a09f3-3afa-47dc-98ae-acb28ba668ec,0,36,0,0,36
b1114cb8-f3b2-42fd-bdbd-338f66b8673b,1,75,0,0,76
b1416719-e4c2-462d-85f0-776ee1ead351,0,32,1,1,34
b16148db-7312-4fea-91bb-fb167345aa75,0,35,0,0,35
b18a5104-c69e-4a76-a0e5-ba38b0833f59,0,15,0,0,15
b190b6bf-8adc-484d-aabb-d2e0dd7399ce,68,0,0,0,68
b1982608-092a-4cb5-88d0-93a2e513216d,1,66,0,13,80
b1b319d0-6482-45dd-83cc-d1cab5138f2a,0,34,0,0,34
b205bacb-eecf-4a72-ba52-3ab330318c39,0,77,0,0,77
b2e5d8be-127d-4cec-ba02-0b781c2736ff,0,19,0,0,19
b303094e-e6c1-45e4-962e-464ae22a555c,0,75,1,0,76
b3165cb8-71de-4c87-87f9-3662126a2c66,35,1,0,0,36
b334c087-9c78-4a07-8334-afca3ce94e21,34,1,0,0,35
b33f2f01-02a8-4ef6-96fa-f1b19b1fd856,0,76,0,0,76
b42245e6-14eb-4575-a8a0-c0c0851ed0cf,0,35,1,0,36
b4a2a83a-265c-43ba-b683-304d777df8e8,1,19,0,0,20
b4fa7655-7741-4fd0-839a-5f63a27d4147,0,15,0,0,15
b51bbd80-09fb-4928-a7ef-16b462b9545f,0,77,0,0,77
b5218527-3731-4f70-ad27-8d5b38182d58,0,74,0,0,74
b58880a5-4cad-412b-ac48-698f26ad6e8c,0,71,0,0,71
b59ee250-5f93-4b6b-a2dd-4b7155a26fd1,14,1,0,0,15
b5dd4d71-cc63-4f44-91fd-9cf5bcbd64b5,0,77,0,1,78
b5e7da2e-eb53-4136-8a42-68626ea1ed11,0,74,0,0,74
b671ba56-4df0-4d17-bac6-b483c6cd983b,0,15,0,0,15
b6808ba6-7a72-41be-a0d4-fbc7be6dee72,0,20,0,0,20
b6f4dcb2-f8e5-4626-9739-9d80fe90ff15,0,35,0,0,35
b7082a5f-ebd5-4372-b7b6-ca14d0f354fa,34,1,0,0,35
b7258066-47bf-428e-800b-ae9e15c8c27e,0,69,0,0,69
b7401221-99a3-461d-955c-849c64247981,0,15,0,0,15
b746ce82-e2ea-4cbf-b2f3-f6e4de071ee0,0,36,0,0,36
b75b5970-b933-4ae5-9388-9c2323732bf7,0,20,0,0,20
b770fc98-841e-47cf-b93e-c313b1c4fcdf,1,76,0,0,77
b79c5be4-8a0c-4827-bf12-7dd644a43439,0,73,0,0,73
b7a6c3b0-4902-45f5-a89b-de09a329287a,0,77,0,0,77
b7a96c20-8f4d-4827-8b6a-f8e24c9d0ae0,0,35,1,0,36
b7ab8e13-da59-40c6-a47e-79dcf209a54d,0,78,0,0,78
b7b1d6cd-fe24-4aa6-ab38-f2ec47b73e9a,0,35,0,0,35
b82598e9-4d7c-4a63-9326-875823160a0a,0,74,0,0,74
b82c400e-db2c-40a7-b827-45faac3098c0,0,20,0,0,20
b854bd7d-a11d-4897-8a6d-ca183d66a4ca,0,72,0,1,73
b8952190-16e3-49b5-9f8d-7d8b6e085414,0,20,0,0,20
b8ed2db8-074b-4d39-8252-b9243348b0db,0,15,0,0,15
b8f57586-747b-4bfa-990c-30187a3b95f7,0,78,0,0,78
b91f6dc8-4ec0-4952-85d9-411e6069cfc1,74,1,0,0,75
b94ff9f8-ddfb-4197-bc38-18c2ff60c0cd,0,67,0,0,67
b95edc33-fa1e-4b51-aae1-2c41e961e83a,71,0,1,0,72
b982f099-606b-4c2e-9045-7554b651ac83,70,0,0,0,70
b99687df-60b3-4990-abe9-2827dd9da66e,1,18,0,5,24
b9a5891f-6bf2-4410-b37c-f2151bb26ac3,36,0,0,0,36
b9d577bd-f12e-452c-b6de-6b39de1121f8,0,72,0,1,73
b9eaccb0-84d6-4e9f-b961-b5a625324818,0,34,0,0,34
b9fe5e2e-7f86-400a-866c-4ee054dcf042,0,14,0,1,15
ba02356e-0f8c-42b7-8f52-f68af7b5b172,20,0,0,0,20
ba1300c3-0248-46f5-8781-ecabe8dbd8b4,74,2,0,1,77
bad07718-a87b-4fa3-b865-d0a1c9f10f7d,10,21,0,11,42
bad77985-42bb-4f9d-b3ed-f4457d99b43d,0,15,0,0,15
bae8c507-5460-4dfc-b00f-04a9804f6bf1,0,76,0,0,76
bb05ee64-800c-4e6e-821e-914bef9f7f4a,0,18,1,0,19
bb5c2095-1335-4936-b7d5-79d408447b2b,0,34,0,1,35
bb788448-1857-47b3-95a7-8169a91a5ab8,0,36,0,0,36
bb8c96c8-95c6-48e8-92b1-6a68e062f6a0,0,78,0,0,78
bbb08548-aaee-4d36-864b-e3bbd76beb10,0,74,0,0,74
bbe0109f-8490-4565-8dc0-3026d7712e9a,0,33,1,2,36
bc049ee1-6bc7-4bf6-b059-7a63a4f20f20,0,15,0,0,15
bc685702-52d5-4ca0-8004-89e64d16b70c,0,71,0,0,71
bd069dd1-416d-488b-93fb-2373aea4cdda,0,19,0,0,19
bd353152-d1a0-4387-9814-5eddabadca91,0,79,1,0,80
bd58c59e-b232-4a13-937c-37d0f3005f4d,0,19,0,0,19
bd5b00a6-272b-4468-9f90-c5899c880c38,0,15,0,0,15
bd85fce9-af0c-4ad8-a2ac-be62e0e086a7,71,2,0,2,75
bdd6a4ef-740c-40f2-9598-3bcb18548f2e,14,0,0,1,15
be03bd61-dbe5-46ed-8423-4a2b7606bcb9,0,77,0,0,77
beaab9b4-7dd7-43a1-9339-3b8e3b442514,0,36,0,0,36
bef17b42-7ddb-47e2-bffe-e4d46822dfbd,1,35,0,0,36
bef17b95-5772-47ca-859d-db636aae8e6d,0,21,0,0,21
bf053026-271a-4775-a8bd-af94db950e80,72,3,0,1,76
bf094ecb-7375-4b76-abed-5d60d7e3cd90,79,0,0,0,79
bf535961-e2b4-40ee-bc52-7223792e1db0,0,71,0,0,71
bf9a7c48-1787-4e26-bf6f-bcdc40f4ed76,0,74,0,1,75
bfb4bc38-d48b-44c8-b846-c3956bbdae64,0,15,0,0,15
bfd2b082-2795-4d08-bc7e-23db65757d72,0,15,0,0,15
bfe11056-33a1-494c-b4c8-56752da34798,0,77,0,0,77
c027fa2c-8ab8-4b87-aeb1-76969931e27e,20,0,0,0,20
c04d40d5-9b78-4c51-ae7b-08e1a0885e55,1,20,0,4,25
c06f0181-695f-44a6-a5c6-10ffea78655e,0,15,0,0,15
c0762b5c-325e-4f78-b25c-005ce18655ce,0,19,0,0,19
c0874f9a-4f2b-4d1e-b6fa-520319602352,0,76,0,0,76
c09386a3-5715-4bc8-9850-7344e2d6be0b,0,70,0,0,70
c0b4d2cb-7428-48e5-affb-6eef195eec68,0,74,0,1,75
c0c266cb-104b-4a88-ad06-e7b3077851ed,0,78,0,1,79
c1ad3b91-84f6-4fb1-9e0f-3b9bc8a69b3e,0,76,0,0,76
c2003b5e-0c44-4e54-9eb8-771ff626d283,15,0,0,0,15
c246a657-ca48-4100-b90c-7454184dc413,0,15,0,0,15
c2744a16-c599-473e-a07e-a629df306ce2,0,78,0,0,78
c2820c5f-07a0-4dc7-9ce6-1153750c8fb7,0,15,0,0,15
c28bea21-1734-440f-a67d-aa794d2ca6c4,67,1,1,1,70
c314f622-8e4b-406d-af4d-9b5bd2bb5668,0,77,0,0,77
c31db300-fc3c-41ea-bc2e-c954bc15745c,0,77,0,1,78
c35befc6-199b-4a46-94ab-957e0e4a8c10,70,2,0,0,72
c378b98e-6e5e-453d-a4d6-f992f82c2a49,21,1,0,0,22
c3796095-f3a5-4b18-8317-743a665638c1,0,78,0,0,78
c386cb5f-6b9f-4fcb-a16a-fd81bfbbb5da,0,21,1,0,22
c3f18f6f-50b1-439f-aa7f-7ede49be4515,1,67,1,0,69
c401c13e-14d7-4d2e-878e-a616609c6b71,21,0,0,0,21
c403acd8-159a-4705-b717-73170869c6f3,1,20,0,3,24
c44de28b-7407-495c-ae9d-7f3104ae15bf,0,77,1,2,80
c47782d7-dfc4-46db-b503-4795d8bbc35f,0,19,0,1,20
c4902d7f-0db1-44f7-a1e5-99791f20ad4b,0,15,0,0,15
c49b5c8a-29ca-4409-a3fc-ac5d8f9fdf44,0,69,0,0,69
c50056db-7ad9-4b44-aae5-d9120b038749,0,74,0,1,75
c549a94b-4738-4a35-80c1-31943094e803,66,1,0,1,68
c5f19789-aef8-4009-8021-ee1f4148a78c,0,15,0,0,15
c62d6df4-cd97-449f-b4d5-528ae42490f3,76,2,0,0,78
c63c54dd-8995-440d-a5fb-d9198d733534,0,20,0,5,25
c66caca6-b155-4ef6-b8f4-13eef95fddb3,0,79,0,0,79
c6c1a0e6-1d18-433c-a225-f0673c923e15,0,81,1,0,82
c6c3d5ed-c30d-4380-b374-a5848d37c030,0,15,0,0,15
c6cc7ab1-6229-49cc-a571-c054eff13458,15,0,0,0,15
c6ccae62-3846-4d98-b169-9c0eee0c6371,0,72,0,0,72
c6e09c2d-40c8-4fee-8b64-c4dfa10ee38f,0,73,0,0,73
c6e8627a-b726-409f-b14d-314b1279cc48,0,15,0,0,15
c6eec69d-0589-45b0-ac8d-47de7eb5140f,71,1,0,1,73
c70702cc-1f2a-45b1-b142-73df864011e2,0,74,0,1,75
c721d05c-2b1c-455d-814c-ae504cd3ca8d,0,73,0,0,73
c72c9887-92f5-46c6-8d69-6210493213eb,0,71,0,0,71
c7440951-174f-4490-a813-dda2b7157d38,0,69,0,1,70
c77fd028-3c1a-467c-8b3d-4dd7090c0583,17,1,0,6,24
c7953c38-203e-40a5-a01b-09f5c26314c5,0,72,0,0,72
c85234a3-2894-4272-9717-76452181a303,0,82,0,1,83
c874f878-befe-4767-a35d-622a4f501d50,15,0,0,0,15
c87560bc-1e8c-4699-a346-bb4380babb64,0,14,0,1,15
c884c209-d9e0-4c3e-9472-6ae3df8dd9a8,0,69,0,0,69
c89a452a-c9fd-419e-9787-6941626c4255,73,2,0,2,77
c958586a-ea2d-4af9-b463-ae17c898ef73,22,0,0,0,22
c97acde1-9ada-48a3-89f3-d0edc45c6271,33,1,0,0,34
c991587f-26b8-4d56-893f-8d5645bf5937,0,75,1,0,76
c9a0c3e7-3fb5-4f4c-91f1-8a59a420aa5e,0,71,1,0,72
c9cdc5d7-2220-4fc5-a851-91359abf2eb3,0,79,0,1,80
c9ce9225-38fc-4815-81a4-b45e5bb903ba,19,1,0,0,20
ca300f47-5e59-43bd-94c1-1e9fdf15e82f,1,72,0,0,73
ca4e58c0-df17-4881-a2f9-2f4dd90ab479,1,70,0,2,73
ca7326cb-2626-418b-b2b3-c64db150bade,0,21,0,0,21
ca9636b5-d14d-4219-ba27-84ec5a7f17f1,0,34,0,0,34
cb18f46d-2da7-4ecc-b0ff-a75605e84d88,0,15,0,0,15
cb538510-f1f8-43b2-b309-206baba7b892,73,1,0,0,74
cb826d12-edd0-457f-90cd-83678ce33e38,69,6,0,1,76
cbb22f79-4996-481f-ab19-425767c88a4f,0,69,0,2,71
cbbd3db3-aa53-4701-bec1-1f60ffd6cd76,0,15,0,0,15
cc1ae2ef-bf24-4351-b42c-ddbea4c4d7d6,0,71,0,0,71
cc1e9d56-73f0-440e-b20a-68612152e972,0,72,0,0,72
cd242fc0-2af0-417c-a059-a94e7b2940c6,0,70,0,1,71
cd2d6db7-4bc6-461f-9488-7c9c1077c2e6,0,78,0,1,79
cd4c9341-4471-4125-a78e-13f8ffba4d72,0,33,1,0,34
cd902c7e-0527-4376-b35b-41f390c38f17,75,0,0,1,76
cdbe6ecf-7815-498c-90a6-da9ad886d858,0,15,0,0,15
ce24b3e7-685b-42fd-bee1-c3deb63aaf88,0,20,0,0,20
ce99130f-7fe9-4f9a-a7b5-3ddfa19f95b3,0,15,0,0,15
ceaa75aa-69fa-49e7-9c39-2ac6f48c3504,0,20,0,0,20
cf13228f-6d5d-4331-94de-7d9cb64a90fc,0,76,0,1,77
cf16f518-7366-47ce-8846-c75ef871d509,0,73,0,0,73
cf191189-4d6f-403d-b595-b610f7743728,0,15,0,0,15
cf2c31cd-3f13-4aea-a55e-e022c7f3039e,0,79,0,0,79
cf326098-8f9e-4adf-bf7b-088b73732860,0,35,1,0,36
cf44b62e-b3a3-47a9-a9a3-974442e98abd,0,13,0,2,15
cf67e0a9-d523-472b-b6a7-d3f19d9c0931,72,0,0,0,72
cf780e19-3577-462c-ac14-136fa7924792,1,19,0,0,20
cfaddafb-c036-455d-900e-b70c061822ec,0,81,0,0,81
cfbdbd30-a982-4bc7-86a5-816d65415413,72,1,0,0,73
cfeb94f3-50b0-4102-9e44-f420354ce044,0,69,0,0,69
d03afc8e-1401-4e66-9940-5f2999e391fd,21,0,0,0,21
d04976a3-058e-478e-9bc7-8d4ae78750c9,69,0,1,0,70
d081b82a-cddd-4f56-88b3-627162109889,0,75,0,0,75
d0cd5012-6a8b-49f9-b76b-472625874743,0,20,0,0,20
d0e0f592-3578-49aa-aa20-41f73e3fb7ea,1,78,0,0,79
d0eaf0e2-508e-4a1e-b1b6-2ffbf904ae44,0,76,0,1,77
d158aff6-dca6-4c76-a012-bb4a830e2049,0,72,0,0,72
d18e3bdf-cc90-49aa-8db9-80f7f64efec0,69,0,0,0,69
d1e538e6-b185-425c-9499-3645506ed3a8,63,3,0,2,68
d1fb08f5-06ad-4dfd-966d-3453a52abf80,0,15,0,0,15
d207a584-01e7-465f-b7f0-f1c9c2e71e9d,0,69,0,0,69
d241e2a1-ada4-4749-a5eb-5b20bac41651,0,77,0,0,77
d265eae6-2641-4c35-86b4-525557e91ea0,0,77,0,0,77
d2d5bbf5-70a1-43d9-aa5a-b03299ed6f87,11,3,0,1,15
d2dea901-f7ab-419e-945f-9a7544678efe,71,1,0,0,72
d322deb0-356e-49c5-b8ca-621691a0590a,0,81,0,0,81
d35f92d3-5981-4fb2-bf64-3f875a2f6d21,0,81,0,0,81
d3edcb30-9f02-49b2-96f0-7864e3e41282,0,71,0,0,71
d41994c4-adc8-4767-a180-202764461910,14,1,0,0,15
d45b56b0-7266-4740-a51b-54fc3fc5267b,1,73,2,0,76
d46c94ef-eb02-46ff-b581-3a8bb05b83c7,0,75,1,0,76
d4fd7fe8-7823-4fa1-91ff-8cf9be9de287,0,19,1,0,20
d52d9106-e227-48e7-bc0d-0ed5809b7a75,19,1,0,1,21
d5401273-25a4-4acf-93a2-a891bc3e27fb,19,0,0,0,19
d568b14e-b870-4bed-b822-18ff7eca0edf,0,71,0,0,71
d56e93bb-d182-44e0-a706-957ae0c974da,0,75,0,0,75
d5870570-ad42-45fc-9734-412de84c75de,73,2,0,1,76
d59e04ea-0ccb-45f4-b38e-a7ddb1bf9dc2,0,19,0,0,19
d5b56b6d-ab2b-44d6-b89a-aae6566258e0,20,0,0,0,20
d5e5e3d6-36d2-4fd4-af9c-5cbc6fc753f5,0,15,0,3,18
d5f00dc4-8454-4f52-8236-0dab6df529c2,0,72,0,2,74
d5f39a5a-e7ce-423a-aad8-90fa5f8a5fca,0,74,0,0,74
d600cc16-cfb7-4981-8f37-ca806b98b43e,0,15,0,0,15
d6246b75-2960-40fb-bb6d-cd37c002d8b8,0,21,0,0,21
d7054388-8f62-4613-bfb1-6b182946962f,0,15,0,0,15
d77d878e-0bad-4d61-a2e7-cf1a40bc4ff2,0,76,0,1,77
d77e9c02-fc0b-4094-8c56-e75a68b309bd,0,15,0,0,15
d7b21f1a-859f-42c0-b312-9cf49a8cf810,0,67,0,0,67
d7d0b5e3-ef36-41c4-bf1a-d5d72172848e,1,76,0,0,77
d83ab664-a71a-4751-aac5-4dfdfb9097cc,0,73,0,0,73
d83c792e-c9b8-4fed-8db0-02200e954451,70,5,0,0,75
d8a5c6af-1f95-4950-b03c-33069604ef23,0,75,0,2,77
d8d455d3-1968-485f-adec-5e4061c15e26,0,34,0,0,34
d8d6ed9b-b322-487e-ba0a-681447ba7de2,0,20,1,0,21
d94e816b-f702-45fd-8ae0-322e42e50e00,0,33,2,0,35
d972610a-0d6a-4dfe-871a-d38c863bf2dd,0,21,0,0,21
d9874ca9-b457-45f9-9052-f849381b8ad9,0,15,0,0,15
d9a19239-562b-4875-a64c-5794ac13d918,0,19,1,0,20
d9e333ac-d885-4d3d-95c6-e38a424cf88a,0,15,0,0,15
d9e526ce-3db6-4664-aae4-4055f2802910,0,15,0,0,15
da7db01f-0ffa-49bf-a67f-addd31dd2e52,68,1,0,0,69
da8437ee-ca8c-43f7-b72a-8d6446860dca,0,34,0,0,34
da85d05d-e93f-41b7-8511-b75c29c2e8a1,0,15,0,0,15
da92ab8a-8307-475d-a01d-9bad8007c0f3,0,20,0,1,21
dad0f455-74c5-4db9-a33a-2bb51e4b5641,0,71,0,0,71
db10949c-98f9-441a-af39-960b86e4ba33,0,76,0,1,77
db6a2506-502d-4b6b-accd-27aabcd5af8b,0,20,0,0,20
db9c7390-3ba5-4476-9315-14c693b48c99,0,73,0,1,74
dbb03568-c37b-4f9f-b34e-f3b51d38df36,2,33,0,0,35
dbbb2f5b-0de3-4784-9802-270ca8199f9f,0,15,0,0,15
dbf0681d-d09a-4445-9ddf-26c02b005f71,69,3,2,0,74
dbf3edb7-67ac-4172-a5ad-b41d58ed0e3f,0,15,0,0,15
dc191a69-dce8-4faa-8926-d7d3a6bb5723,0,70,0,0,70
dc647c7c-c712-4118-8d8c-29330e031c96,75,1,1,0,77
dcd08376-50f7-498a-bbe2-f1ef5dba85da,0,35,0,0,35
dcf83408-2141-4326-bae5-7d48d9e71f6a,70,2,0,0,72
dd13506c-6dee-4255-a05f-d63903c51588,33,2,0,3,38
dd386d63-2747-4bea-bda4-60353c2b6bf6,0,65,0,0,65
dd616977-85c9-4914-99aa-ea7ed8135f5e,2,75,0,3,80
dd7a8108-6106-40d4-8a45-1a72bdd5d857,0,68,0,0,68
dd91014c-9a03-4e25-bdcc-d4d032717ab1,79,0,0,2,81
ddc105f6-583e-45cb-8245-a49eee241aeb,0,72,0,0,72
ddf3cbdb-189d-4fd3-99a0-0b8a72d3e450,0,22,0,0,22
de0fa8f6-01c6-4675-82ae-9ad986f2f2c0,1,68,0,1,70
de4da575-a5a5-4812-9eaa-f2b8f5ab86e9,0,15,0,0,15
de766ed8-8776-43d5-a34b-40de124b2c18,0,14,0,0,14
de82bd68-f40f-4172-aaa7-220a1427ac86,71,1,0,0,72
de9f0625-8ac6-443f-a0b3-3557226e1d80,0,20,0,0,20
e02af86f-6808-48e6-89bf-f0983a4149d8,0,15,0,0,15
e06b74a2-2e40-4c89-8f77-cbf5dce25f90,75,1,0,0,76
e09079a7-6609-4fe8-93b4-bd499637e130,0,78,0,0,78
e0fa8be9-c754-4a0d-a0f7-5af7c4ad57f8,0,15,0,0,15
e1642f82-040c-4b22-bdb8-5b88291b431d,1,14,0,0,15
e174ecb6-08ae-4002-afb1-985092ca52a8,0,70,0,2,72
e2341d1e-aa0c-4d77-828a-01fdb863760d,0,20,0,0,20
e238ccf1-20d1-4eb8-b8fc-79c0f0d3f3b7,15,0,0,0,15
e259a414-eff4-4bc4-8f63-8563e19aed59,0,78,0,0,78
e2765f91-1570-40a9-a26e-08cec632e2ba,1,80,0,1,82
e2ac4781-7e39-4113-9b7a-5ee2bdb13460,0,22,0,0,22
e2b77e9c-fbd5-4134-8e24-8de18c09e8ea,2,17,0,5,24
e2f9259f-fca5-4202-9aba-4d8272e433d5,0,76,0,0,76
e3250ec5-ccbb-46bb-8814-b4f29fdb153b,0,15,0,0,15
e38334f8-2c69-44d7-aa9c-9d1039d98e44,0,79,0,0,79
e3a5f695-9c50-4d35-b05c-69672eca5af5,0,35,0,0,35
e45858b5-7d54-4be5-8247-d1fe80d466b0,0,75,0,0,75
e48ac777-1a8f-4b84-a787-f63bf20b167b,14,1,0,3,18
e4b77952-3fa0-4151-a109-48401bc9946d,0,19,0,0,19
e4d4685b-56b1-4704-b24d-34d1d0698a39,0,20,0,0,20
e4f70387-6954-41f6-9229-c61399920a7a,0,21,0,0,21
e549cc61-81f3-4fa9-b528-61e73d7794b9,1,74,0,0,75
e54d243b-5ed0-4eb5-b7c8-6e0d1bb290ae,0,76,0,1,77
e58446a5-a01c-4a19-a29b-70c3bfc3ba80,0,68,0,0,68
e5fdfd92-50f1-413f-81b4-82f17012d042,0,75,0,0,75
e6241e32-41e5-4a37-9b02-d2f10cfb51a6,0,35,0,0,35
e6ab9297-24b1-436f-8773-982a5c769965,0,81,1,0,82
e6afced0-3514-4bdb-8025-9578f0609cbd,0,20,0,0,20
e6b4c181-4202-481c-84da-a3b0c4c0ce42,0,35,0,0,35
e6cb64f8-adfc-4df0-ad4b-acd5ebcce164,0,35,1,0,36
e6d396f1-8496-45ea-a00b-8bc418daa45b,0,19,0,0,19
e6e8a74f-5c0b-4098-bbe8-c0db7cbdb90f,72,1,0,0,73
e6f82796-6e18-4e5c-a29b-d3bf97661066,0,34,1,0,35
e6fdbe78-7860-4b09-a6a2-1a36e476233c,0,21,0,0,21
e78d5cc3-2851-448f-a5a0-c7b96e103d70,0,35,0,1,36
e7ad99ec-4e4b-49ea-9893-a3eef3ceb2a6,0,75,0,0,75
e7ae595e-131b-4e98-ab01-ba3437a56cfd,70,1,0,0,71
e7ccbf54-71dc-409b-8156-1d1c2f520f86,73,1,0,0,74
e7e06020-d834-4c95-8cdc-d611325d78a3,0,73,0,0,73
e7e1fd88-d30c-4fcd-977c-dfaba881dec0,0,75,0,0,75
e7fd6740-648e-4acb-be86-8c9214d35f70,0,78,0,1,79
e800b6bb-59d1-4539-a000-4f71f0367221,0,20,0,0,20
e886e180-acf5-4288-8a73-437e44b12447,75,1,0,0,76
e88ef16a-e6fc-4527-8442-1b55b5759f6f,0,19,0,0,19
e88f15fe-72fb-4ff9-a29e-9dd59f78be51,0,76,0,0,76
e88fc8ab-06a9-4601-8d79-d03bb0919068,0,71,0,0,71
e8c49ab4-99b3-4b26-87aa-344468e50884,0,73,0,2,75
e91240df-65fb-41ef-af68-d9af0645684b,8,10,0,4,22
e91bdae1-14c4-41b9-a1fe-2d553b879c8c,0,15,0,0,15
e9668d12-231f-4c2a-9b2b-ae70da112d85,0,74,0,0,74
e984ff42-3c14-4ce4-9423-d042ed40d20a,0,75,0,0,75
e99c3e7d-2598-4c33-aaaa-104789fe9511,0,15,0,0,15
e9b8acc6-00bf-409c-af15-fda6e060bbd6,33,1,0,0,34
e9c5d397-5fcf-442c-b27b-cf9d9791ccf1,0,73,0,0,73
e9c8f7bc-35fd-493b-9d63-fecbf02a1247,15,0,0,0,15
ea06007e-372a-4def-8516-17686652a334,0,74,0,0,74
ea3dd95d-5e19-42d3-859a-fcb50e5ad8c5,0,35,1,0,36
ea5f196d-c498-411b-8b90-a019354f2dca,0,15,0,0,15
eab527c8-fd11-4147-b06c-26c8cd26d50c,0,72,0,0,72
eb0ae4b3-f155-4c46-a81d-41867be97ab1,0,79,0,0,79
ebde5d28-8c6a-4285-a43e-b7f5cd3be5a2,0,12,0,2,14
ebf25781-c9e2-4971-8af4-f4ba03d40724,0,21,0,0,21
ec3bd13d-8b32-4d27-aa65-6aa26e319cf6,0,78,0,0,78
ec914731-0b3a-480f-9509-be91bb245021,0,68,0,8,76
ecaccaf9-bee4-421d-863d-8478d283d34f,0,80,0,1,81
ecd0f76c-f3ed-4d92-9034-b12bf49732f2,0,15,0,0,15
ecfaf573-6f02-46e0-aecb-829a81ca1a00,0,74,0,0,74
ed4a7ae5-6f73-49a0-9872-84eb6f5ab6f4,0,15,0,0,15
ed575f01-b950-420a-85c2-b482af288ef8,0,71,0,0,71
edd46a8a-7191-46e7-ae03-d469b97ee9e7,0,71,0,0,71
edd4be04-9f0b-40b9-b7a1-99a63983e9e3,0,80,1,0,81
ee686849-6bac-4b9b-8ac2-45f235790a6c,0,74,0,0,74
ee80a597-8dd5-4e08-8111-b5887d3a5ae4,0,73,0,0,73
eeaa59eb-d9df-4780-9dd0-a0a887848c89,71,2,0,0,73
ef05a07a-5ce8-4e4f-9c71-7d528b357ff6,74,0,0,0,74
ef126943-a50e-4c68-a274-c0a9c7bff151,77,0,0,1,78
ef372df3-6f2c-4185-b351-23203913a6d5,0,17,0,1,18
ef58aaca-2272-44aa-8f09-a11628254a76,0,36,0,0,36
ef944b72-dec3-4c11-9177-d839d1996385,72,2,0,0,74
f0130dc7-ee89-4d2b-a3bc-253a0a226cd4,0,19,0,0,19
f0876254-1a7c-4965-8c75-5c68b63e3a09,1,12,0,5,18
f0939a64-c8f0-4cc2-9e69-4613c769551a,73,0,0,0,73
f0bb615f-c584-4850-a64e-e87de40d169a,0,74,0,0,74
f0c81fe4-ea12-4022-b49b-e4f33ccd5dcb,0,77,0,0,77
f0dcdb26-99ca-48ed-88fc-b635de51c62e,0,76,0,0,76
f0e95251-affb-4cc6-a15c-18f99137f589,71,0,0,0,71
f101e6c6-c0db-4406-be25-efc809dae88e,0,15,0,0,15
f13b6802-e329-494a-b778-fc4fc6f95b90,0,15,0,0,15
f1b64c9b-25cc-41be-8e9a-0829961e56fe,21,1,0,0,22
f1cbbdc0-5fb2-400b-afff-fb1b64d73fc0,0,76,0,2,78
f1d20f16-4850-468b-acf9-e41c789f78b7,70,2,0,0,72
f2b39816-81f2-4d17-8c58-56ec25344c90,34,1,0,0,35
f2b4e13a-4b12-4fae-85a5-9e9eb5669162,0,71,0,0,71
f2e94257-a37d-4cec-935d-8f30b9f589b7,75,0,0,0,75
f3098f63-f37a-4bae-98a6-3b9b642a1723,0,75,0,0,75
f32fbc93-98a4-44a5-82de-aea07a8094cb,0,73,0,0,73
f33e7d71-9459-44b5-a9c6-8be40b2a8231,0,18,0,0,18
f3511209-35e5-4ff1-a079-a74d7c59ab9c,0,21,0,0,21
f3c9106b-5815-4e5c-81d3-cdfdd1877217,0,15,0,0,15
f3d661ce-06ac-4201-b9e3-557655b992cc,0,19,0,0,19
f3e73d47-676f-4653-a2a0-fd460b7946d6,0,75,0,0,75
f3f17430-5661-4afc-94a5-8a0ec83fa485,15,0,0,3,18
f3fe19cb-8a9c-4b8e-adf9-8d24dbddb9b0,0,33,0,1,34
f4005293-d951-4781-9f4c-db7d0cc8a91e,0,34,1,0,35
f422b764-c3e9-4334-98b1-fd13d09873d1,0,14,0,1,15
f45fcf28-da42-43ca-994f-431ef1b2c701,0,76,0,0,76
f4a3051e-c55d-4a5c-9ac1-96879bb3cb5e,71,2,0,1,74
f526370a-f9ea-470d-b584-591b8bba9aeb,19,16,0,5,40
f5c12d57-49cb-49fd-8095-0970398a315b,0,15,0,0,15
f5dc68c2-f56e-4dca-afde-46546db75a3a,0,15,0,0,15
f5f069df-c60b-4cca-8414-027c9e02d769,0,76,0,0,76
f613eb5e-b24c-438e-aac4-d0e6c58179dc,72,0,1,0,73
f667b6a9-e42c-4931-9fa3-d944a2de623f,75,0,0,0,75
f6933ace-79be-433c-a295-5b0012bbe309,0,20,0,0,20
f6d88867-c9b8-4a00-81a0-3f8ca5cc2d45,1,75,0,0,76
f70abc75-6aba-4889-a463-54ea00a54615,0,15,0,0,15
f70ad22a-c234-40f4-9ac5-46318ff081ee,0,75,0,0,75
f78168c2-730b-44c1-9e64-b3c158e046aa,0,80,0,0,80
f7c0c6c5-b881-4815-ae29-c476494992cd,0,72,0,0,72
f7cf7e17-c804-4548-8225-9443d527b805,73,0,0,0,73
f7d231bd-b934-4fc2-95ea-575599e4b017,84,2,0,0,86
f804b903-6682-494f-a495-f78c6c867073,21,0,0,0,21
f8637d9b-8952-4949-8189-a723d76b70a3,0,15,0,0,15
f876101b-7ac5-414a-87d7-c16dd408b3e9,0,21,0,0,21
f8bcf8ed-e8a8-4f19-b8e0-be4d6eed8629,73,3,0,2,78
f907367c-2241-4d4b-96a3-9271e6218c86,70,0,0,0,70
f90ef47b-c154-4bdc-af7c-ecebc1383eee,77,3,0,0,80
f91f59a0-4c51-4e5d-aa3d-b1fbc62bf221,0,36,0,0,36
f966006e-e5ba-430a-b458-b28589da24df,0,15,0,0,15
f98ebec3-59f6-4b91-aee4-534956fb9ec1,0,15,0,0,15
f9b9309e-bacb-43e5-8a37-eddd62230f5d,73,0,0,0,73
f9e90d18-1fff-4978-8dcb-29a4ea943716,0,71,1,0,72
fa0fd42b-bc56-40d7-9143-efcb12033655,0,70,1,0,71
fa220394-834e-4387-b082-db54d3f3dab3,0,22,0,0,22
fa46da08-852f-4a22-aa25-a102e4a592fc,0,69,0,0,69
fa5133f7-311c-4a68-a929-42948cf64632,0,13,0,5,18
fa89a6f0-8f2b-4035-8987-2328cd2526a7,0,19,0,0,19
fab10009-38f8-4555-bcc6-d9a9cd5ab85e,0,33,0,3,36
faebd21b-ea1e-4a94-99ef-09149e8457e0,0,75,0,0,75
faf4fc56-f37f-4c11-9ee8-00c52a72e16d,0,15,0,0,15
faf9644d-c4b7-4bf6-99f8-64bbebec0000,73,1,0,2,76
fb9c13fc-01a5-456a-97f0-27eb2213335a,0,20,0,0,20
fba32bbb-17f1-48b8-8797-2d534987b17d,0,73,0,0,73
fbc2ab81-a69a-468d-834a-1eccf0a1da20,0,34,1,0,35
fbf46e66-5d7e-40ad-9b35-10a2a54ce838,0,15,0,0,15
fc3dc026-c1d4-4bdb-8207-aef8e8bb32db,1,14,0,3,18
fc4efb5a-9c7e-4388-bc67-75e3e4d37e80,19,1,0,0,20
fc56017c-ab67-46b5-af83-f9763af5faa9,1,77,0,0,78
fc7f5ead-397b-41ec-b100-0102ab212cc5,0,77,0,0,77
fcad8e40-d7dc-4c71-9883-cf180301585e,20,0,0,0,20
fd3f4348-2f4d-4da2-9928-78ef403d1d11,0,66,0,6,72
fdac1ea6-83b3-4af4-8c5e-9a8b920d9871,0,75,0,0,75
fdb006af-5e40-41a9-bbba-94267e76dbd3,7,17,0,1,25
fdb7b487-0685-480c-8340-3a193ddc4d76,73,0,0,0,73
fde77dfc-5be9-448f-8626-7a1ca46661e6,77,1,0,0,78
fea6ed03-3a0a-44b4-b5ba-3a6560a56b95,77,0,0,1,78
fecd8f6c-f295-46a4-8079-65f19323adaa,19,0,0,0,19
fef022ce-f2d6-4830-a4da-d059454b0451,0,71,0,4,75
ff1acb42-a327-41e1-ab43-8f505cee3d44,0,19,0,0,19
ffb68602-aba5-483d-b8da-94d9060be2f3,13,3,0,2,18
ffd1c1e2-82a4-4e1b-a522-859cff7f372f,70,1,0,0,71
ffdfc5f1-332b-4919-9452-571c01ce8c7a,1,20,0,0,21
ffe205c2-7ba4-4512-9f04-66f9665da733,0,66,0,3,69
ffedc291-8826-46a9-aa9c-7c40fd474542,0,18,0,2,20
