uuid,female,male,other,skip,total
00198c8c-8a44-4cca-87c9-bb9a4e10f67b,0,3,0,0,3
01773f06-bc7c-445a-a130-8afe5b353333,6,0,0,0,6
01814293-dc31-4572-ae10-d5ca36b71cec,5,0,0,0,5
025b2af1-02aa-45a5-91e4-000287d4fcbf,0,5,0,0,5
0278b272-b5be-4bac-a57e-3673596ff622,4,0,0,0,4
0288cb4b-8c1e-4a52-bf9c-21b68bbb0d28,0,3,0,0,3
0296ab75-e545-48c2-8df6-6fe177092bb7,0,4,0,0,4
02d33111-58c5-4970-90c4-6e3f0b5f3f58,0,4,0,0,4
02d6d05e-96a9-4e7a-a519-e5a748e998de,0,4,0,0,4
03946b8b-3c90-45f2-a48c-358f2d97ebd5,0,4,0,0,4
03c1d965-8d71-47b5-ba2d-ce269dc93efe,0,4,0,0,4
05a5f554-62a1-4ded-a8d7-9b125b04edcc,0,3,0,1,4
05efbc04-7ab8-4e20-b43b-5ba92a5007b1,4,0,0,0,4
05ff64ac-f60f-460a-bf21-cc36f16b3dc8,0,5,0,1,6
06fc262e-7652-4c59-a24d-288640634d6f,1,0,0,0,1
070a328c-69d2-4e3b-a486-f766837bf59c,0,6,0,0,6
0766b09c-0786-4f7e-bbd4-8f4ed55b9276,0,2,0,0,2
0766f57d-221f-4a45-b076-8837d85277df,5,1,0,0,6
07eb1c15-397f-49b4-8e93-dcf18f238a61,0,2,1,1,4
0813ac30-a867-4c9e-bbf9-c9c00fe1ff88,3,0,0,0,3
0873d352-5aa9-4a80-aeff-f04cfc82338f,0,4,0,0,4
09940d30-feea-4e6d-8a6c-97ac7a91a9e2,4,0,0,0,4
09f28f42-1552-4692-b61b-c57a01d09ca7,0,4,0,0,4
0a0e992f-7134-40f3-8d84-1683d8a9fbdf,2,0,0,0,2
0a1bbe8f-596d-48ae-bf8b-c4bbb2fe44b1,5,0,0,0,5
0a3c9042-e547-454c-a11b-1dfb1c1fc302,5,0,0,1,6
0a5d98ec-3a02-4285-a562-65e79124d471,5,0,0,0,5
0a7e048b-3db7-4859-adbf-34f9fd958560,0,6,0,0,6
0ad37f8a-17e7-418b-a76b-415ba90c8d46,4,0,0,0,4
0ae9c93e-0944-4177-b271-bd404a2299be,4,0,0,0,4
0b0bfbcd-ccf9-4270-868c-fb1d79d6e0ef,5,0,0,0,5
0b0fea6e-8b5d-44db-bc36-55e28ed4c9a2,0,5,0,0,5
0b6fe442-bd2c-4c4d-adc8-25089a9a4da1,5,0,0,0,5
0b940286-6ec0-4439-ab24-ffe4f22b5b30,0,5,0,0,5
0bb7ab34-9220-4e5f-b04e-bf7376c4444d,6,0,0,0,6
0bf18144-81af-4e01-9ec3-eac2d5c1fc56,2,0,1,0,3
0c141cdd-4979-41e5-a2de-e87600ab6a4b,0,4,0,0,4
0c182a76-18c3-45e3-9e48-079799a0beda,0,5,0,0,5
0c24b585-34da-44f6-b750-368f5995e56a,0,5,0,0,5
0c625458-134c-47e3-90c1-f4e541e992f6,0,5,0,0,5
0c895401-1c24-4e15-b392-58e7a2855ba3,0,1,1,0,2
0cb8f7f0-532d-4fc1-8059-28625cae52f8,0,4,0,0,4
0d0133c3-52a9-4bfb-9b8d-b3fdbc66f327,0,1,0,1,2
0d11e169-3b56-4418-abae-15926f0ccc86,3,1,0,0,4
0d21dccc-0b63-4c2f-9085-7d4faf0c6bfc,0,4,0,1,5
0d80be5c-08c3-4e17-9e6d-d7e8967ba96d,1,0,1,0,2
0daa8a31-50be-44c9-b1eb-74ad99216009,5,0,0,0,5
0dc6352a-4c5d-4877-8489-18757ed5532d,0,5,0,0,5
0de88965-1279-4f43-b1be-991b23f119c4,0,7,0,0,7
0e3775e9-8f2a-4d7e-9583-bffbb7410995,0,4,0,0,4
0e54b5cb-3d36-4aca-8984-81b6a20883b0,5,0,0,0,5
0e5d7e9a-f352-46c7-9320-0cc197db27de,0,1,0,0,1
0e9532ce-58aa-4456-92bb-e7a85f6fdfd3,0,4,0,0,4
0ea5262d-ddc4-4739-88ff-829724070bcd,4,0,0,0,4
0eb974f7-c75c-4cc5-bc32-df48b9cec0de,0,6,0,0,6
0f1a4516-a9ab-478e-a02d-ddcd3d396eb5,0,6,0,0,6
0f6da591-7f93-47d8-b9fc-7c3a6e2f7625,3,0,0,0,3
0f9b5d69-1194-4a1a-ab44-572e95f12740,0,5,0,0,5
0fc99bdb-d392-45dc-b145-04331bc78c13,5,0,0,0,5
1009dc12-b5af-4414-aea7-5b87a10eaade,7,0,0,0,7
10726493-9556-4343-b5d2-ce988ab45871,0,5,0,0,5
108026c0-ebad-4dfd-af70-a6fa57f3f1ef,0,4,0,0,4
109123dd-51b6-41c7-9cb7-3d8660d73329,0,4,0,0,4
10ace717-211c-49aa-bf84-3df2bb472163,0,5,0,0,5
10dc3f25-a3f5-437e-8844-c65cd0e145cb,0,1,1,0,2
11105566-816a-415e-8251-96659b6293d3,6,0,0,0,6
116bd47e-a3ce-419a-909d-1eb0e8b3829e,0,5,0,0,5
11755a87-9f7d-46e3-a9b7-2d90eff50c55,0,4,0,0,4
11d38fb4-f739-424e-a8d0-728739b94190,0,2,0,0,2
120b3593-def9-4865-b456-4d8fb724c777,0,5,0,0,5
12e0fc9b-0c3e-41b8-b604-59dfdf811261,3,0,0,0,3
13093da5-6974-41ce-b0bd-bd050697a712,5,0,0,0,5
1372365f-3591-430e-b415-b1b0c37b6f2c,4,0,0,0,4
13916da4-08f3-4def-847f-188becda98f9,0,2,0,0,2
139c5b77-c631-4fbf-b749-dad80e582079,0,5,0,0,5
13b70424-d7dc-46a7-8b74-cd2b67185098,1,0,0,0,1
13cc9608-9926-4511-920e-0fc15f30ecb3,0,4,0,0,4
142d2e58-60a2-42b0-b94f-9b96a312401c,0,2,0,0,2
143261e5-71dc-4ae4-a7fb-def9f0e304aa,1,0,0,0,1
143a6919-af38-4581-b3fc-b8989850fad7,3,0,0,1,4
1459ea49-0480-471b-bc66-b074cd1e6019,0,4,0,0,4
14a2361f-ccde-4eca-ae73-6e1ee78aa17e,1,4,0,0,5
14f1baa8-3e46-40a8-a935-8055d9ed6a40,4,0,0,0,4
150fec07-c054-4485-a2ff-2f8063c53848,1,0,1,0,2
1517897e-63e1-4018-8f3d-b009a21b4de6,6,0,0,0,6
151f32fc-381e-43ed-bbae-a0563ebe41d5,0,4,0,0,4
15285f19-dcdc-42fb-9c86-f5bde6505f8b,0,5,0,0,5
1533663b-de8b-4c6e-9712-65cdc1928e04,0,5,0,0,5
157e12fd-0af7-4560-a113-48319ec8ac66,0,5,0,0,5
1595441c-fb25-420e-9aed-7b77aeb9a182,0,5,0,0,5
15a92df7-0c44-4122-a83a-dd19fd961f98,0,5,0,0,5
15b13f63-27c2-4b64-b32e-7d24f8287aad,6,0,0,0,6
15bf7722-d2b5-447a-a96b-d7f920e04c83,0,6,0,0,6
15c5b78b-2ffc-4805-99d3-f050b39f7718,0,5,0,0,5
15c70a05-b2ff-46bb-a793-64b8a9312118,6,0,0,0,6
160ada0e-73fa-46cb-9bf9-1c5c97c2f1de,0,5,0,0,5
16442862-93cb-420b-9ac1-d3f30da2dfe7,0,2,0,0,2
1645fd6a-d5d0-4e4f-8051-940f4f21da29,0,1,1,0,2
168012cf-99bd-46e1-b1c9-545b6f7a05c7,0,4,0,0,4
17623b22-2e32-4bad-98c3-64eea527a6de,0,6,0,0,6
176416ee-1daf-4f71-890e-4025d29e6230,7,0,0,0,7
17718f72-d8af-4ff3-a75e-941e8f8948e3,4,0,0,0,4
17a03fdc-8b96-4165-8ba6-096dcccfa108,0,1,0,0,1
17c985ad-50cb-4852-a086-02a73e6a1773,0,5,0,0,5
17ed4f12-78d0-45c2-93a0-797cf7cddad0,5,0,0,0,5
181a6956-60ce-42be-8a67-aa2693bdcc80,6,0,0,0,6
181db0c4-d7a2-423e-a22b-6201b95ca11b,0,4,0,1,5
182032c5-dddd-4e42-baa0-e54f04a1592b,0,1,0,0,1
1832c01b-3300-4fae-808b-a68d79157a09,0,3,0,0,3
1878c719-c1e8-4064-a33e-30c0eae5b6ed,0,2,0,0,2
188a3f7b-d869-4555-ba22-7d584de76e35,0,1,0,0,1
188e3a28-420d-4106-be7e-0e35664742bd,0,3,0,0,3
18a5d267-f181-4555-bad2-31a595bf925c,0,1,0,0,1
18b9bf41-ba5e-40c4-b259-7bee430eecf9,0,4,0,0,4
18d6baea-0c6a-4146-bdb8-94873ef5dbe3,0,5,0,0,5
18f0e01d-1d2a-4f7f-bea3-5b325eb0c69c,0,3,0,0,3
18f243c1-3338-4e7c-a09d-a67f0ec366d8,0,5,0,0,5
190843f5-bd70-495c-8d4c-8c2eaa43e9dc,0,5,0,0,5
190fc750-b327-431b-ab60-783999062452,0,3,0,0,3
197410fc-6ec0-4aeb-9fcd-0f43e5a06e14,0,5,0,0,5
19d199e4-d4a5-47be-8b24-eb09e2fccbcc,0,5,0,0,5
19e1d707-2b92-40f9-9bcc-ccecfa82a628,6,0,0,0,6
1a1ec178-dd78-496d-ad4a-70a6d1aa7d33,4,0,0,0,4
1a3b93a7-c0e8-400e-a3aa-32c580340e10,0,3,0,1,4
1a5dd087-3182-4105-a918-5a4af9041d0b,6,0,0,0,6
1a73cd79-c798-42f5-bd15-75b514a9fa68,2,0,0,0,2
1aaa1d0e-9f36-4338-a817-0055588fe345,3,0,0,0,3
1ae8aea6-3166-4d22-9efc-20a00ccacb80,0,4,0,0,4
1af5f044-45dd-4d37-8591-3006c11bb408,5,0,0,1,6
1af79e08-85b7-4215-8d24-064bfd1d85f2,0,6,0,0,6
1b311bcb-e1b6-4122-879c-15380c5c5535,0,3,0,0,3
1b3eb8a2-6145-43af-842a-17b3fc1cde44,0,5,0,0,5
1b911f1c-41e4-46ce-8f3a-62e5c7abcd7a,0,2,0,0,2
1ba45ac5-f218-4064-b8c1-85cf0507283e,0,2,0,0,2
1bd2afaa-cdb2-4aab-9178-1b7d08211eac,0,3,0,0,3
1bd553de-40d1-4c0c-b6c8-3c1a47b8cabb,7,0,0,0,7
1c1872a5-12bf-4693-a87d-e26fd0a456fc,0,4,0,0,4
1c837412-dd66-4199-84c4-55139fd2d4ec,2,0,0,0,2
1d2d2740-134b-4db7-b50b-f89d3b2d1c5d,5,0,0,0,5
1d37c705-fecb-44a2-8c24-456d24ac4af3,0,5,0,0,5
1d882d15-f7ed-4074-a664-ef9a8d15dc6c,0,5,0,0,5
1e19ec84-4c93-49ff-a238-d53a9f95c7f3,4,0,0,0,4
1e1ff590-1647-4d71-b433-fff021e88e0c,5,0,0,0,5
1e32d465-7ebd-4f69-a12d-1567d0d64c5e,2,0,0,0,2
1f2af282-1c29-4581-843c-3b8e1fb8f3c7,0,8,0,0,8
1f7abbe3-74bb-4dda-820d-7e11fea09231,6,0,0,0,6
1fc9319f-7c55-42cf-a06e-2364b0ced098,0,5,0,0,5
2040b078-9b08-4914-aaa0-72561ada4165,0,5,0,0,5
206a0d8b-82be-4981-9b56-63f341ee3eb5,0,1,0,0,1
2089ac20-5086-4861-8cd7-93c7bf3d188b,4,0,0,0,4
2093b5fc-dc2d-4da1-933c-1acfb6f06a60,0,4,0,0,4
20c56036-2bc2-4fbf-813d-fc18dc8c6b42,0,1,1,0,2
20d84d98-6896-4cc2-8ad4-feedbb149c66,0,5,0,0,5
20dc2504-fda6-4522-a908-12325a0c7fff,6,0,0,0,6
2112288d-9866-4173-9aee-8f08e977de20,5,0,0,0,5
2135f23e-c554-49ae-9bf8-2d5ab556e107,0,2,0,0,2
215c91f3-d213-46bf-a9c3-8d57de45c114,0,3,0,0,3
217d04a6-9437-4f30-ace1-edf6dd1889c8,5,0,0,0,5
217ffc3e-3baf-4e38-be30-2cff92dcf790,0,1,0,0,1
2189473f-de48-4c17-a64f-e8ed82cca15b,6,1,0,0,7
21962b75-bca4-4902-9502-57691e932de6,0,3,0,0,3
21bacdae-5f99-42d6-873b-91068f9dc021,0,4,0,0,4
2257f7d5-8663-4099-a767-cfd6bc67cdfa,0,5,0,1,6
22b3aa66-60a8-40e0-978f-1dbaa236c5e3,1,3,0,0,4
22e0d142-2297-4e38-a422-2a7c4a3b9da2,4,0,0,0,4
23214ef1-9225-478e-93c5-d2800eda6c34,0,5,0,0,5
232a7653-3f71-4b90-921e-1dd7267cbb77,4,0,0,0,4
2367a0d4-8626-4d49-8810-2b756567b735,0,2,0,0,2
239b8ae6-9d07-456d-a916-0875ee26e204,0,2,0,0,2
23d97aef-ae21-4b2e-855b-45a72717929a,5,0,0,0,5
23f8208d-67b2-4f62-8c50-bf766630af50,0,4,0,0,4
2497f684-06ee-42b1-a4d1-294979f37141,0,3,0,1,4
24d13cd2-c306-490d-b8f7-c40c038d2b26,0,4,0,0,4
24d811d4-fe8b-4b80-8981-70d0b4858a20,0,1,0,0,1
2500d0ba-0591-4871-ad1b-bbe19a080d41,4,0,0,0,4
2550b117-d376-4cc5-9d54-79f26e11fb00,0,4,0,0,4
255a5a7f-1ff2-43c7-bafe-f81a1ad1c147,2,0,0,0,2
255a7f03-1df7-45b9-a01e-707605ab36db,1,0,0,0,1
25d904a4-bc21-40a9-a9d2-83747717e800,3,0,0,0,3
262b2519-a997-442b-a405-6b29f9683adc,0,7,0,0,7
264e54ce-287c-4d4b-a7b6-4caffab151e7,0,2,0,0,2
264e8058-20e6-4f1f-a258-d82416cdf3d3,4,0,0,0,4
26cae6a4-faed-4950-a5f6-6d5cc4e88ea4,4,0,0,0,4
26e1842f-8283-4db0-8b32-a80ce114dabb,0,2,0,0,2
26eee26e-6942-4c18-8034-428390e0a6c5,0,4,0,0,4
27240083-48cd-496f-8e79-a4a875a2b260,5,0,0,0,5
275d08cd-8e20-44e6-a7ca-c05b4a7a9d6b,0,6,0,0,6
276e4df6-8d37-4f31-aa3c-6fc6ebbed6a0,0,2,0,0,2
28295403-718c-4e29-9e6e-1545f229ab2d,0,6,0,0,6
28f9b8c1-dff3-4865-a7c8-34641a1afa29,0,4,0,0,4
28fbc4a7-9168-41bd-9257-1aa73af20413,0,1,0,0,1
2906369b-b467-44a6-91c8-69ca34753315,0,6,0,0,6
2942db1b-472c-4a07-87d8-45b1df588393,1,0,1,0,2
2959da3f-efd5-47af-9c21-a6ed8183c21c,1,0,0,0,1
296702c3-4ca4-4804-a22c-3f5bc3d0cc9a,8,0,0,0,8
2985aedd-4705-460b-9c97-3d9a35099846,0,3,0,0,3
298e2a0a-eb9b-43da-afd3-3f397921fd46,0,3,0,0,3
29c36ac8-c8f7-435e-863c-f4b251bb00f7,0,1,1,0,2
29eb9900-5a90-482d-a6d6-a65974f4acad,0,4,0,0,4
29ff2120-19ad-4083-85ce-bf4fcc52f2be,0,4,0,0,4
2a0d47ff-53b7-46c0-aae2-8c3078d295c0,0,2,0,0,2
2a52ab36-bed4-485e-aa73-f2c988a2b170,5,0,0,0,5
2a793082-e2e5-43d3-a5a8-33bd90637738,0,2,0,0,2
2a7b2edd-9e79-44e9-b977-84c90682f552,0,2,0,0,2
2a84294f-f903-4c43-9d46-d1bbd9427a0a,0,4,0,0,4
2aaffe6f-af5f-4162-beda-380e8054ca83,0,4,0,0,4
2ab3801c-ebb7-4559-ba1f-0b72a12439db,0,4,0,0,4
2acda41a-837c-4a75-a18a-8baf36dd5549,0,5,0,0,5
2ad0cf65-71d4-4484-aa55-ec2ceeeeb97d,4,0,0,0,4
2b06fdcd-86a6-4dc6-9f4b-a749af0231d4,4,0,0,0,4
2b39c9bb-2209-4db2-b757-a8a39b70e948,0,4,0,1,5
2b8bd898-b396-410e-997e-894f76fc505a,0,5,0,0,5
2bacb7a3-8915-4644-ba9c-da8118d962ee,0,3,0,0,3
2bbcaf92-a2d2-46ee-89e3-6edb497018a2,0,5,0,0,5
2c315674-4578-43c5-89d5-737eaeaae7f5,4,0,0,0,4
2c336c57-39e0-4281-95d4-18d9762dc8d6,3,0,0,0,3
2c6d64ee-64e5-44ad-b6fd-cbb8b2373a3f,0,3,0,1,4
2cac0bb5-f15c-49ea-abc3-cdb4f1823a0f,4,0,0,0,4
2cfae8fd-0d5a-4ba0-86b9-6c147bcb8e3f,0,6,0,0,6
2d413a4e-3112-4721-b198-7d386b463e9e,0,7,0,0,7
2d69ed53-bb19-49cb-9196-c381f940ecf0,4,0,0,0,4
2d763147-713d-4b10-ab10-b472bc679656,0,4,0,0,4
2e2b28db-5273-4c72-b64a-13d2d6d9bb11,3,0,0,0,3
2e46f8ef-3905-4149-bfb9-b8e9227a1709,0,5,0,0,5
2e98fbad-45ac-49cb-8c49-dab23671201a,7,0,0,0,7
2ea35500-2f46-40de-8906-f3bacbfd604a,4,0,0,0,4
2ed01a1b-b369-4719-b497-a47e31d51df8,4,0,0,0,4
2ee5c2b3-4e18-427a-ba7f-46d20ccaca0e,0,5,0,0,5
2f14ef6d-cf3e-456a-bc1f-4f4533bd1baa,0,5,0,0,5
2f5f3e73-fbd2-4a5a-9b40-05521f260823,1,0,0,0,1
2f5f8e97-cb5a-4d2d-bac8-487406e83fc4,0,2,0,0,2
2f7a5353-f6a1-4e0b-8c9f-02f3c36e03ce,0,5,0,0,5
2fc7ea88-73fa-4aba-85a0-b3b552c49d98,6,0,0,0,6
3029020e-85e4-4567-b9f9-0ef5bfdaca46,0,4,0,0,4
30292700-a9ee-41af-9df0-5012f98badfa,0,6,0,0,6
307bf7df-7b4f-4a5f-9b08-8584a9acfaef,0,3,0,0,3
3093047b-c449-43da-b925-c68fc71c5148,0,5,0,0,5
30da872e-2c05-4615-a382-af785d28b479,0,6,0,0,6
310bd73e-25dd-4caf-9ba0-48971e164041,0,5,0,0,5
312be337-8ee6-4434-9dcf-311dd497a6d2,0,6,0,0,6
313d6d83-a0f1-4045-b8e8-50b1641316ad,4,0,0,0,4
31ad29d6-e2cd-4c48-879f-7ee7769a8d53,0,5,0,0,5
31e1b303-4b08-4b6f-bbe6-4b9a74d1f766,3,0,0,0,3
31eb52c5-9ad3-4261-aad3-0c9823ea472d,0,6,0,0,6
322b985a-a196-4717-ac8f-bd03bb458c70,0,4,0,0,4
323ea0cd-a01b-434d-aa51-e1afac963d16,0,1,0,0,1
328b165e-5778-477b-be2a-27660be2783a,6,0,0,0,6
32d631fa-1fb0-4abe-bc51-acfd421577f5,0,1,0,0,1
32f4966a-6fbd-46f7-9916-5f81c448d8a7,0,3,0,0,3
33148da3-5360-4eb8-9497-2f852faa5a42,0,6,0,0,6
3386c989-9446-4e74-b3de-bc7621ec34ca,6,0,0,0,6
33c5c57c-31da-4f67-a146-076778b90d45,0,4,0,0,4
33e41c33-20c0-4946-ae2d-25529808fdb6,4,1,0,0,5
343114f3-466c-4b81-9766-34643eed0ef1,0,2,0,0,2
3506bad3-4085-4bb7-bbb2-22dd67765637,0,4,0,0,4
3513b9b6-b8bf-4268-b2ed-33c2840b9b55,0,5,0,0,5
35c208c7-c3b6-476a-8f76-e596613b2c27,3,0,0,1,4
362d5731-2fa9-4ef9-a7ab-54f994e97ad9,0,4,0,1,5
365454fe-8afc-41e2-9daf-8a8ecd6dbc23,0,3,0,0,3
36c0f8e5-509c-42f8-a3e8-3deae6f8f29a,0,4,0,0,4
36f7e664-bbbd-4487-ac50-8ce0a467e06d,0,1,0,0,1
36fa8609-6bee-49f8-b03a-a8ae83184a9c,4,0,0,0,4
3756b536-9c73-42e6-b027-51cf46656571,3,2,0,0,5
37736dec-e6ff-4bec-a3f5-bfd842a79b6f,0,2,0,0,2
3792ad6a-6d18-4253-b02e-bf7f8426d3f1,0,6,0,0,6
37c58c75-eeb4-412e-a881-fa2d1fc7610e,0,1,0,0,1
37f56116-04b8-4894-9b62-b16d636c7eb4,0,5,0,0,5
3812a2d8-d521-43a9-af8d-79fed65ff434,0,2,0,0,2
3889d21d-4240-4cb8-ab6d-c41a28a0890e,1,0,0,0,1
38aa4a44-54a8-4a29-b109-5540ddabc3bd,0,4,0,0,4
38e514d2-f261-4653-b5fe-0056608df34b,0,5,0,0,5
38e8bae1-fcb2-4e37-8da5-4d4243b3d3c0,0,5,0,0,5
38f90ec0-5ac4-44ba-914e-1ccda32e13f9,4,0,0,0,4
392019c4-0603-4d36-b402-d2f4f3c54132,0,5,0,0,5
3924b098-7f1e-47c9-94be-104f14001d0e,0,6,0,0,6
3930e5c1-0c19-4c87-acc5-461c04181f91,0,5,0,0,5
393ddd2e-c759-488b-bd07-f135a6f9f8fb,4,0,0,0,4
3941d85c-f7ca-4c6f-a9f1-09d9fb3b028f,0,1,0,0,1
39f87da8-7f32-4ca1-ac7e-05d7ad71b212,0,4,0,0,4
39febbe1-cae4-428e-aba7-f820815fb699,0,3,0,0,3
3ac017a7-f081-4110-a1be-d8e554615aa4,0,1,1,0,2
3acc3287-1da4-441e-95a8-1cea7bfc737d,4,0,0,0,4
3b285b6c-f7e2-4351-839f-b872e1371b0d,0,1,0,0,1
3b436941-0d85-4887-b3c5-516bce5351f2,0,5,0,0,5
3be2cbc8-cac4-4716-be72-877385d721ed,0,5,0,0,5
3beb0fd6-797b-48f8-b816-e8db71dfd8b3,5,0,0,0,5
3c149bd2-6f7b-4001-8e08-baf5af38e8fb,0,2,0,0,2
3c19745c-87e3-4877-aeb0-1d8e90cdf649,0,5,0,0,5
3c24bd0c-9f01-4ba0-b0e8-2df183664d6e,0,4,0,0,4
3c60b24a-1ea4-49f9-a042-cb0fd78c103a,4,0,0,0,4
3c7aad6f-b7f0-4149-b824-1463e120f986,0,6,0,0,6
3cac7c9c-298f-434c-b4e1-11c4bc066cb4,0,6,0,0,6
3cb14f13-ed43-4bd6-b276-aed7509cb1bc,0,2,0,0,2
3cc54ba2-c1f3-449d-9eb1-e46e458b1cad,0,2,0,0,2
3d4911b0-f587-40b3-9612-af2354c55e03,0,5,0,0,5
3dbc34bc-c7db-4700-ae7b-243958ca9756,0,3,0,1,4
3dd19264-7f9a-496d-907e-c6bc1a327974,7,0,0,0,7
3de32a0c-1d1c-4cbf-aefa-db9b918318b4,4,0,0,0,4
3e080f9d-50a9-4c0a-a72e-5ed0ef155984,0,4,0,0,4
3e0ac78e-0155-41ab-b725-9ef0823b6f30,0,3,0,0,3
3e10f1fd-2385-4b7f-87d3-068d2be6125d,0,7,0,0,7
3e14bfac-901e-484c-b9cb-377597dafe9e,0,1,0,0,1
3eb6871b-6405-4f30-b1d7-c5dbf0aee955,0,3,0,0,3
3ed07268-12d4-4512-abd4-c305d53fc11b,0,4,0,0,4
3fc47104-86e8-47f1-bf24-57904eb3428b,0,2,0,0,2
403c425f-55af-48c3-8ba1-99625a52de6e,0,2,0,0,2
40ca96de-cbef-4003-b008-f775d2610dfc,1,0,1,0,2
4173a2ce-4772-4edc-b2c8-d5bf63db0e19,0,6,0,0,6
418f5ec9-271d-476d-843f-7cbeda5d6f6a,3,0,0,0,3
4198d8af-1119-41db-b17f-a73584fc7302,0,1,0,0,1
420048c7-aaa0-45f0-bce1-823080019359,0,2,1,0,3
422f25e0-969a-47d6-86ff-baeccd7a54f7,0,3,0,0,3
4275d876-d03a-468f-adee-9f690bc3d7c4,0,5,0,0,5
43247a30-a2d7-4e7d-8fc0-eb27194ff797,0,3,0,1,4
4329d885-7632-4468-960c-22f2f6419a7e,0,7,0,0,7
437fab12-0be6-48ff-9d60-3bc9030b8e72,0,3,0,1,4
4382b012-7179-4180-a208-0b55b03c27f8,1,0,1,0,2
43c534ef-e4b1-4520-bbe6-d9fada4cb387,0,1,1,0,2
44a4272e-0a47-44a8-8056-46f655dc3bfc,0,4,0,0,4
44b838be-c0d2-4767-b2f6-3c12663c7b2b,0,3,0,0,3
455501eb-0e1b-4cec-9cdf-c5d00434d42c,5,0,0,0,5
45bc3297-2646-41f3-bc07-7e01ef8a0b0d,0,4,0,0,4
45f413a8-662a-41af-90d3-f4bc6f11a5ab,0,5,0,0,5
46169d99-625c-4053-bb8a-310c46a68e6b,5,0,0,0,5
463b0cb5-9c56-4a9e-a9a8-b06be10d2582,6,0,0,0,6
465f1434-f751-4ef7-8f90-280031d8e6d6,0,1,0,0,1
46614639-84bd-4610-b899-c7378c3a70eb,0,5,0,1,6
4668cbee-f776-44c0-8a5b-884acf742d03,0,4,0,0,4
46f07c5f-d350-42be-8f22-4d1ca2339fb5,0,3,0,1,4
473369ce-8ac1-4092-8b3a-504638910650,6,0,0,0,6
47b1b58d-33ad-484a-ad89-541a6700d03f,3,0,0,1,4
47d75069-4338-45e7-ba7f-5427926a3d8a,0,6,0,0,6
4813b193-4f1f-455c-944c-8f8548e37265,0,7,0,0,7
48146863-e6e8-4a92-9ad6-81081c5692b2,0,4,0,0,4
4834bf71-1219-435d-8229-17fdfe15c50b,0,6,0,0,6
485c06d5-95b3-419c-89a3-1dac113090f1,5,0,0,0,5
48622b2c-5350-4f41-bba0-1cbaef275864,0,3,0,0,3
48ba818a-5bc9-4de1-8024-25953e505d23,4,0,0,0,4
48e62152-d6f9-459f-b380-43492f247a4b,0,5,0,0,5
492e64f9-7bc8-4f57-9b7f-1fd5f2ba00e4,0,6,0,0,6
492fb1d4-6224-4917-a688-54ff64564f8e,6,0,0,0,6
49b4a434-2c16-44a0-92de-ac95834bc425,0,5,0,0,5
4a1463a9-5915-4338-842a-cfdd7c3aacd9,0,7,0,0,7
4a2829c8-5b10-4814-a4d0-cf43a2b0467e,4,0,0,0,4
4a4c8612-204a-4308-ac4f-ae7478a017e3,4,0,0,0,4
4a583108-9c1d-4d0b-a0d6-d8ca32ea43c5,0,2,0,0,2
4a5e353f-811f-4cef-82a9-0c0a6524095f,0,4,0,0,4
4a729ff3-60c3-47c2-87e0-6a298b207bc3,0,5,0,1,6
4ac41214-922f-4a18-8cef-f27bbb6fc90e,0,4,1,0,5
4af04f4e-e417-480c-a3e7-8a06d3a82372,0,3,0,0,3
4af3577e-6a6c-4195-b78a-5cd07992dc9e,3,0,0,0,3
4b33d098-9a84-45a8-b07f-7286989fd17d,0,4,0,0,4
4b4838c3-d487-4dea-a2b1-79885f86ea2b,0,6,0,0,6
4b650d2c-1e95-4759-a905-4b3badec36cd,0,5,0,0,5
4b9897a2-c0d2-4cc3-b983-2c3ae3e2861c,0,2,0,0,2
4bcfdfc1-bfeb-4ddd-9675-ac2e10e4d1cc,0,4,0,0,4
4c35bfa6-4b94-4f4b-9d18-58c93ea777a8,0,4,0,0,4
4c592bad-7b9c-401e-9cd1-e6b430cf9c29,0,3,0,0,3
4c75fa3c-1cca-4feb-af1b-86948d23c21d,0,5,0,0,5
4cccc457-a8be-413c-a6da-2763572853c4,0,9,0,0,9
4cd0c1dd-ecaf-4a58-9dab-7385571e0f90,0,8,0,0,8
4cde844e-82fd-4c61-8846-2f3c1341a5d9,3,0,0,0,3
4d53436b-c4b3-40d4-899e-1bd6c85cede9,3,0,0,0,3
4d698da3-dfc5-42c4-92e6-0b89c8441cf2,0,7,0,0,7
4d8365ee-880b-4a5c-a00e-0835e1fd021a,0,1,0,0,1
4dd31c6d-65e4-4f10-81ca-f002610e84e6,0,3,0,0,3
4dd58d1e-3e0e-4910-854f-4c10e987a00e,0,5,0,0,5
4e799a5f-b4a3-4c5d-808a-2b19e89b2c6f,0,3,0,1,4
4edaa695-b7c5-482e-8986-24a72f0986df,4,0,0,0,4
4f9ab97a-858c-4b00-903d-290e4dab0c30,0,4,0,0,4
4fdd7ba6-f11d-4e53-a9ad-9ea9426041f3,0,3,0,0,3
502bb966-825a-4b77-b180-36e3dddbb0a4,0,3,0,0,3
503639e2-e1b3-4057-a8ae-b35c28b5d74a,0,1,1,0,2
50f37f5b-5fa6-4f26-95e9-746beefebbe6,0,3,0,0,3
5188f027-9510-4a75-9165-87ea402e18d1,0,4,0,0,4
519d0f62-9ad6-4012-b790-72876366ecbf,0,1,0,0,1
52077cec-08f5-46b1-b474-6a5fd347f7d4,5,0,0,0,5
523e6fb4-ebd3-4b6e-a5ff-48391ed0c8d5,0,1,0,0,1
524a1ef1-8c56-4739-a38a-265ba9621f09,5,0,0,0,5
527fdfed-0718-458b-9046-542793f1c119,0,2,0,0,2
52987d27-9ef9-4389-bec3-6d43ec6dd732,0,1,0,0,1
5315c2bc-4055-4799-a8da-8dd9054f2728,7,0,0,0,7
5326e99a-71ea-446c-89f2-56e95196d5d8,0,2,0,0,2
53572522-f1db-4d26-aec5-5b6f7d9f463b,0,5,0,0,5
53bcc148-e34c-4022-9e66-b11e6be9b951,0,2,0,0,2
544727ad-3f66-4556-ac8b-bd1871f84d28,4,0,0,0,4
54622059-914e-4921-9b55-4ad912241279,5,0,0,0,5
552d8610-f7e6-4957-abee-31285d5929ae,0,6,0,0,6
553cbcaa-30d2-4b59-98f8-f0864a63a08b,0,1,1,0,2
555c460c-9a57-4201-b769-23b105b82a28,4,0,0,0,4
557e4938-25ed-4ed2-ac09-5d63d8093e49,4,0,0,0,4
5598856f-1afe-42ad-b8fa-630daeaefca4,0,3,0,1,4
55c97abf-3e2f-44f2-83c0-8d7fc3e93687,0,6,0,0,6
565dd7c3-cd76-4bc6-9919-599f1b4b9abc,0,2,0,0,2
567b288b-2aba-41f0-8cf6-1823058ccc36,0,1,1,0,2
5685839c-f05b-48a5-b1a7-db2cb33ef8b3,0,5,0,0,5
56c007aa-f8a4-4acf-b9ec-07023980e0f0,0,4,0,0,4
57379dce-633b-40d3-87e1-94960d9de4e4,0,6,0,0,6
57a821a9-a21c-414d-a309-7b2a0f8edc00,5,0,0,0,5
57b5bd66-661d-4d2a-83c6-bd44fa9b03c2,5,0,0,0,5
586f5309-879d-434a-981a-019f56feb3ce,4,0,0,0,4
58bb4edb-0995-4ea9-a9f8-ae3a0bb4cb11,3,0,0,0,3
58bb53b5-19ff-421e-a705-ecfd0640cf0a,0,4,0,0,4
58c20262-48f4-4a4d-bf8a-0037c2f19100,0,5,0,0,5
59007f58-2814-4b58-a15a-bbc10b0823d9,0,4,0,0,4
592434ee-870e-441a-bdb3-d36c18dd94a3,2,0,0,0,2
595cf283-eea7-4979-a760-49fe3f6e00b6,5,0,0,0,5
5a32876c-768f-419f-bc57-052262351b6b,0,5,0,0,5
5a397f7e-b22d-4d3e-b919-4604383b2cf0,0,5,0,0,5
5a7b99f6-bfb5-409a-afe4-a625a78c5d83,7,0,0,0,7
5aa9915f-51ae-48f0-9f0f-2d30f137cb13,0,1,1,0,2
5ac09a07-c16e-4418-a32d-0ae8bd72aa62,1,0,1,0,2
5ba6a9e5-af1f-475f-a876-1e45b151257a,0,4,0,1,5
5bd2a94f-e7c5-44d2-805f-d11740c0edfe,7,0,0,0,7
5bd5d763-f556-467a-a16b-30057ae64429,6,0,0,0,6
5bdc0f0e-08b2-40ce-ac74-8dcdb1811dfb,3,0,0,0,3
5c26914e-7849-4dd3-87d4-edad02bbf4ab,0,5,0,0,5
5c5a5e0b-c3d7-43ca-b275-253c3710a3e0,0,1,0,0,1
5cdf1e64-170d-4b7e-9495-3edd09d40859,0,5,0,0,5
5cfbac2d-51a5-4c59-856a-930e06b1c76b,0,2,0,0,2
5d3b3695-d353-482d-9824-b2f83a58b817,0,5,0,0,5
5d8828ac-4365-4e53-af1d-8b4e94ab37d9,0,2,1,0,3
5d8a675f-1145-40e8-87fc-f1932058c5fd,0,4,0,0,4
5de8874c-9187-4686-9d64-eecd66ad080f,0,1,1,0,2
5df5695b-c2aa-42c7-83c9-1957510a2532,0,4,0,0,4
5e4f9dc8-cbf3-4ab8-b310-a8661fb95934,2,0,0,0,2
5e68f1f4-4a4c-4632-a236-496829a99299,0,2,0,0,2
5eb0c02c-68c8-4b30-9130-c2078603a841,0,4,0,0,4
5ee07cfb-f1e0-4d70-89a4-02f4a1674e55,5,0,0,0,5
5f03bbc4-21ad-4d16-b09c-3b8e3d9cd99c,6,0,0,0,6
5f2d97c6-9ffc-492a-aa8a-951db736778d,0,1,0,0,1
5fa98d37-7e6d-4712-a5c5-eaff7e30c78b,7,0,0,0,7
5ffa0ee3-1257-4620-b6ed-7ecdf899f9b2,5,0,0,1,6
5ffb712b-43fd-4f6c-84c2-9da12f88c6e1,5,0,0,0,5
5ffbb993-2a47-4dc1-91ea-e8e26ff5605f,0,4,0,1,5
60a4ec4a-f4f4-4942-aa4b-94b817bae17c,0,1,0,0,1
60c68c23-195e-45b5-ae8e-947f816a4037,0,4,0,0,4
60f49de2-42ae-4806-971f-18b0ad881943,0,5,0,0,5
617bd57b-83f4-43dc-b99f-7d19a0103890,3,0,0,0,3
61872d64-4dca-4d62-a180-109a4a138ade,0,1,0,0,1
61d85107-abd3-4631-9b17-344da2a9fb86,0,4,0,0,4
61d9d724-a016-4099-ae45-bf4c56fc8837,4,0,0,0,4
61f2e2b8-b0e2-4808-8a02-1419f8500a72,0,7,0,0,7
61f831bb-98a5-4c6c-9330-3c41901c16f4,0,5,0,0,5
6242a6d1-907f-46c6-83ef-c728b6c773b0,0,3,0,0,3
624d7809-7583-48c9-bf76-f1df9629a848,0,5,0,0,5
6270bb4f-f4ae-444c-93a9-c5f5dd009999,4,0,0,0,4
63288e3f-8dc1-46bd-b98f-cfa0b0e54141,5,0,0,0,5
63a5661f-ffb2-4b24-bb8e-2cc684702c93,0,3,0,1,4
63cc42fc-55cd-4031-a7c3-76cfa09453c6,6,0,0,0,6
63fcbf2b-8d86-4039-ae76-35cc35be5576,5,0,0,1,6
6465af70-b601-4a7d-87ca-b9461bc78430,0,2,0,0,2
65d21a0c-1591-4dc3-9fca-58f89e718448,0,4,0,0,4
65fb99df-7b27-415d-8469-bbde10754bbf,4,0,0,0,4
66581baa-c8fe-4d62-a4d8-406ce4d13fc8,0,4,0,0,4
668b5f43-f039-44eb-80d5-7aaa0d033baa,7,0,0,0,7
6714aa1f-af5d-46f9-b485-c763c6acd9f2,0,2,0,0,2
673516d5-9806-4e6e-9777-093acae9fffe,2,0,1,0,3
67882651-5698-4003-b812-f7cc49690f6d,0,1,0,0,1
67a44842-29e7-4d2b-bccf-826cc3cbcaeb,0,6,0,0,6
67d2602f-e1cc-4d12-98ae-8c0c2457f005,0,4,0,0,4
67d9bcf7-69c0-4871-9115-6809f76d8f8e,0,4,0,0,4
681e30df-e277-421f-954b-aeb7256cc714,2,0,0,0,2
683ce1c7-0f75-4eff-8c48-b682489b5b4a,2,0,0,0,2
6864eb6e-4552-4776-b85c-bd9fce2285a9,0,6,0,0,6
68761d96-cd1e-4597-aa39-437801542f57,0,2,1,1,4
6900df32-e289-41a5-bdc8-0039a7abaac1,0,6,0,0,6
694f2044-be45-4340-be9f-3303b17d83ba,0,2,0,0,2
69726836-d25b-468e-a354-fde537e115f4,0,4,0,0,4
69a4bbac-ac73-4875-a852-e497894a9f87,0,5,0,0,5
6abbd3cb-d89d-409f-950f-923a1e8abb14,0,3,0,0,3
6b483422-f0aa-4f17-b9c0-4e99bfb487c1,4,0,0,0,4
6c2c95cd-990d-41d1-bf40-aa2b828a7e43,0,3,0,0,3
6c69fad5-b946-47b4-b387-419743f7a866,0,2,0,0,2
6c74a150-6c12-4678-b9b9-9faf19c62dd7,0,2,0,0,2
6c9c994c-0e40-401d-a0bf-26de21582888,3,0,0,0,3
6d0e07c5-bf24-454d-bcd1-9075fbe3b831,0,5,0,0,5
6d9cb2b0-6dd9-418f-9419-178646635850,0,5,0,0,5
6e0a0af2-c5dd-4442-ae1e-16fd3e96a683,0,4,0,0,4
6e0a4b2a-358e-447b-abb6-30347da4e6f0,0,4,0,0,4
6ebbca03-5cd0-4eb5-ae4f-8edfa6b428a6,0,2,0,0,2
6ec4b67a-7acf-4c34-9ac7-3ea4bd5b0075,0,7,0,0,7
6ed4c3cb-c899-49af-bc54-231ca80ed240,0,6,0,0,6
6f1041fe-ecc1-4bc1-b679-2280acf61422,0,2,0,0,2
6f35f4f7-a3ca-40b7-8fd8-e6d07086f371,1,2,0,0,3
6f61fe0e-274d-4298-b5e1-79b6a0749861,0,5,0,0,5
6f6cb18d-3355-4e9c-b04c-d0cb228f8801,0,6,0,0,6
6fb90690-4a03-4df2-80bd-a701f5876c49,0,4,0,0,4
6fd744b3-43dc-4df3-a48e-4a73cae240a8,0,7,0,0,7
700e4756-d311-4780-810f-c84f5aaa42dc,5,0,0,0,5
7022661a-ad58-4056-a566-bb0abadc9d8e,0,5,0,0,5
702ccaca-cbb5-434f-8169-525264fa8474,8,0,0,0,8
7031e87e-3949-435a-ab74-92a5969c3bfb,3,0,0,0,3
704fe8ae-d125-4268-bc8f-c42588c7fef5,2,0,0,0,2
70c19efa-7791-44e6-a3b8-01efd29ef22a,5,0,0,0,5
70f79f7b-9de8-4bcd-a660-3b1af7bb061a,0,3,0,0,3
70f7ae26-caf6-4cdd-b3f5-8342c22a0fad,0,4,0,0,4
715d295f-8c72-4dfb-a945-cc1cfe567b80,0,4,0,0,4
71d74d39-ccb0-4dec-9357-80eca626087d,0,3,0,0,3
71dc2c89-0e43-4b6e-afea-50dd4728cffe,0,2,0,0,2
71ebfc40-f778-4a8a-a083-2d8391e998c1,0,4,0,0,4
71f13c85-43cc-42f1-9110-54d6a2607383,0,3,0,0,3
726f3b7d-1d42-4369-83ec-7b6e90a4270f,0,4,0,0,4
7291f727-31f6-4250-81d3-dff68213f0ae,2,0,0,0,2
72b5e188-0df7-4608-93bd-463a1f6c5d9f,0,5,0,0,5
72e6ab22-2c19-4e5f-8de7-a5070ccd372d,5,0,0,0,5
72f1363b-d2a7-4bdf-a566-01fe1aeeac48,4,0,0,0,4
7321f34c-f483-4563-96ac-b81dea13fb15,3,1,0,0,4
7335c1c2-55a5-4317-9358-9de76d3863ca,5,0,0,0,5
733c2380-748d-4d4f-8bff-2d9124160213,5,0,0,0,5
7348300a-09d3-4d0a-8ff5-9577aac02d9d,0,5,0,0,5
734e533e-8eba-4b76-b9a6-d2340195a13a,0,2,0,0,2
736ee0fa-2d5d-424d-82f2-6c880bcc5f08,0,1,0,0,1
73956463-3bde-4299-aa42-b66f43cfd4d3,0,6,0,0,6
73afacf3-c8df-40df-8472-a72a2e51e5cd,0,3,0,0,3
73e1e5ed-d58c-4c36-9437-17579634f220,0,5,0,0,5
744bd9b9-7042-45d6-858a-4c7c63297b2e,0,1,0,0,1
74990528-4174-4e0c-829f-fd8337f69117,4,0,0,1,5
7524cc76-1423-45e9-ba30-5f10448f7d8a,0,2,0,0,2
75724fd8-09af-4eff-8262-22b2878b7450,6,0,0,0,6
75786700-ed2e-4730-bf20-48389329a248,0,5,0,0,5
757e984f-d593-49c2-a0c8-fa32d28a2363,2,0,1,0,3
75ab7ccb-93dc-4fa6-9880-734b48e9f573,5,0,0,0,5
75ce2a47-49b9-40e8-b68b-a90c4b427098,0,2,0,0,2
7639ddf3-7496-4bab-9ee7-535f4db93c9c,0,4,0,0,4
7688e910-69ae-46e8-b766-ecaad6f885f8,5,0,0,0,5
76937d6a-4ea2-4222-b566-83696a379764,0,6,0,0,6
76dc222f-773d-47b8-91b1-b82c3adb7df0,0,1,1,0,2
76f40bf8-1c9e-4d15-ad3e-4c8116175713,0,5,0,0,5
77223b14-ac1b-45c8-919e-8d759d88a97e,0,3,0,0,3
776f5de6-d181-48cc-8f4c-fc229237176a,0,3,0,0,3
7785bb70-0812-4981-99e6-e35d0533259b,0,5,0,0,5
779f1f53-5d89-4cf5-919a-24911e7493c6,0,6,0,0,6
77a65a38-5365-4e36-ae3c-2f7740668f26,0,6,0,1,7
78327a51-4d29-4b98-a752-7e692fb27c2d,0,2,0,0,2
78f96466-cf59-4dd1-a919-2d9d6ece0e72,0,5,0,0,5
790178c6-55ed-409c-949b-e23c695caf6e,0,5,0,0,5
7905289b-b0a1-4c8a-b334-9f8dbf56ba86,0,4,0,0,4
7945afef-e6d7-4515-9cca-dc27a616568c,0,3,0,0,3
79bd3da4-a502-49d0-95b8-f8ff481f841b,5,0,0,0,5
79bd80cd-13a6-47c0-baf6-287932fb53f0,5,0,0,0,5
79dd101d-459f-4817-9bd6-bf0db4933d39,4,1,0,0,5
79ff7f3c-6ee7-4147-9c8a-6811ec283b9e,0,7,0,0,7
7a4caaa1-301d-4b86-8bc4-5d555f8d00b0,0,4,0,0,4
7a87bb0f-ea61-4aa6-8f32-c6c27f404599,6,0,0,1,7
7c06fddb-b00e-4e62-8f4d-59352222c01d,0,5,0,0,5
7c69d049-2190-4e72-88ae-3237db5fbb44,0,4,0,0,4
7c954580-643d-42ec-8818-37ff56ecefa5,0,5,0,0,5
7cf4f6e7-97ca-4f6f-ac8a-3600ee97003d,0,4,0,0,4
7d1659f4-66bd-42bb-b9a2-06c453954cbc,0,4,0,0,4
7d442db5-ee70-4eca-96e1-fa7d50b33c12,0,6,0,0,6
7d5cb989-a93c-4327-adde-84a4f56c23ec,0,4,0,0,4
7df00feb-f37d-4ea6-ae17-e2d2ad4cf022,0,1,1,0,2
7e0280d8-5c1d-4c06-b77c-b0c61b18a642,0,5,0,0,5
7efbf7a0-3a80-4a88-8fe5-2a0a1d418a69,0,3,0,1,4
7f7d5fbc-52c4-4f6e-80eb-b605b870f7fd,0,7,0,0,7
7f7e0453-1f8b-4bfc-b059-c53119b28f94,0,6,0,0,6
7f8b923a-79bd-4a1f-b8e3-8b05960334b6,0,1,1,0,2
7f95b2b9-8f9f-4361-9ec7-7922371c4777,0,5,0,0,5
7fbbce8c-c5c2-44ab-b4ba-55462f54bdea,0,3,0,0,3
7fbcf08b-46d5-4f4e-b3f6-37226886ef08,1,0,1,0,2
7fc9d8bc-7d92-4745-af1d-1457cfa36e5b,0,5,0,0,5
7fd130f5-4fcf-4a7b-8b99-7463a39f1fde,0,1,1,0,2
8023e680-731e-4e6c-ae47-9a1b7a526570,0,3,0,0,3
8025209d-5841-4143-9bc1-b91c5117b0dd,0,5,0,0,5
803ad806-932b-406d-a5c7-2dc348ea0a9c,4,0,0,0,4
80736b72-5776-4478-ad0a-73a06e684a80,0,6,0,0,6
80e258cd-9db0-407d-935e-11e0cd35a409,0,8,0,0,8
816bc8c5-d666-4e20-a8ca-41a84f26c30a,4,0,0,0,4
81ab88b8-8c9b-4f5f-96d0-86c7b05be813,0,5,0,0,5
81b36885-5faf-4da4-98af-012b367cc446,0,1,0,0,1
81d9b83b-4545-4311-8989-36125a25e6ed,0,6,0,0,6
8217bfc8-5274-4750-b81b-64dd7ac84ee5,5,0,0,0,5
821cd240-4f41-45cf-88bf-726f418022fd,0,3,0,0,3
8234c66f-e96d-4d98-98bc-33a7003b921f,0,5,0,0,5
8237c071-7505-445a-ab59-752baf08f31d,0,5,0,0,5
825ebc16-6f22-430c-94dc-deb21c8ce14c,1,0,0,0,1
82e18b1c-049e-4c1d-9b97-7eac92fd9f80,5,0,0,0,5
82f50ab1-02d2-48cd-94fa-c94da52235e0,0,5,0,0,5
82f6a87b-7d8e-4e86-af64-e23dd98f41b2,6,0,0,0,6
83477bd5-d807-40a0-86ed-9a93d9c8d076,0,3,0,0,3
83bbdb6e-6e2e-4dcb-8adf-7294a7d57f21,0,6,0,0,6
83ce1783-afc6-4c84-9efb-2c551d1da22a,0,2,0,0,2
840b8dbb-7b04-437b-83ac-3965c866570b,1,0,0,0,1
842bf359-2827-4cc0-bd25-1084e7ad1a9d,4,0,0,0,4
84fb59ee-3e89-4869-beef-2d7e767705b0,5,1,0,0,6
8556686c-8b11-441f-8ef8-4243f6c3ea7d,4,0,0,0,4
85a2af29-d097-438f-b334-46da67e32508,0,4,0,0,4
85b6f9f4-836f-4b5d-8ede-ee74ee7799f9,0,4,0,0,4
85c99741-c4bb-45da-af04-8d2016aa2cb5,0,4,0,1,5
85db4abc-db6e-4182-badb-4645a345eca6,4,0,0,0,4
8631f602-669f-4794-be00-9ac1b61116e5,5,0,0,0,5
863e0c52-d9f3-426c-ad42-26a890aeb4e0,0,2,0,0,2
86487d91-e16c-4aaf-93f9-64dcfc69d742,0,4,0,0,4
875ec1db-bc7d-4c99-a472-1079c7d94e26,0,4,0,0,4
8769b3f9-81d3-4621-9e8c-ad11a077c450,4,0,0,0,4
87a7286a-2ac1-4215-8287-6aba5cd8cf71,2,0,0,0,2
87ca36b4-7b43-406a-94f4-43ef68033059,0,5,0,0,5
88589865-08f5-413a-8766-d8acb7f637ab,0,7,0,0,7
8860b6c4-4eea-4c61-b0b7-5063f8bf4416,3,0,0,0,3
88ac4b49-21cd-42eb-811a-0238b2346c9e,0,4,0,0,4
88bd78c3-789f-496f-a936-568398bae79e,0,1,1,0,2
893d9a4d-e213-4132-a7db-9469f9fe8aa9,0,5,0,0,5
8940096b-3fad-4d82-9f4e-077d2c480bf7,0,4,0,0,4
89467877-28c7-4962-abdd-fbc450c30dc3,0,2,0,0,2
89814c19-a649-468f-8ac1-4856b6e96da2,0,5,0,0,5
89b62e0c-a38e-4fdd-a314-24e53aaca9a6,0,6,0,0,6
8a141bc7-0b1d-429c-9f5c-35fef4c63192,0,5,0,0,5
8a31ba6e-b3c5-4706-8969-ff2bb2aa21cd,0,7,0,0,7
8a54633b-83fd-4c46-99fc-3328e9236ada,3,0,0,0,3
8a710da9-10ca-4c89-8626-261fab51eb7a,9,0,0,1,10
8a9648f0-c864-48c3-a7b4-af660f29c739,0,4,0,0,4
8ac405cd-472c-45b6-b299-b1e2966cfe05,0,2,0,0,2
8b493108-63e4-42d2-92a6-6cbbd7022dc7,5,0,0,1,6
8b49baa8-2cff-4b05-975c-e8c025f24567,0,5,0,0,5
8baddf30-9c1c-471a-92b6-f937905dee2a,0,5,0,0,5
8be13e4a-5bda-421d-a81f-9f4c5763ca9b,0,3,0,0,3
8bea13a7-522d-4c8b-bafb-375b74e80f04,6,0,0,0,6
8bfcd188-6f2d-43ce-b1b9-0b6c57871e2d,0,4,0,0,4
8c29cd2f-c869-439b-aaf2-0aedad25470c,0,5,0,0,5
8c56a178-c0b1-4611-9d3e-1920ec6c6c59,0,1,1,0,2
8c75cdfd-fcf4-43fe-981c-d3d4f5da098b,4,0,0,0,4
8d3e0caa-2974-441e-b312-cef5f2687f1e,5,0,0,0,5
8d427aae-f695-45d1-969e-08b7969122c7,4,0,0,0,4
8d7ac8cd-bb14-4b4f-affd-736adf0d042f,0,4,0,0,4
8e1ac90e-8ad1-40ef-9608-cc7d62a9a969,0,4,0,0,4
8f1f39e0-f9c8-4d33-b5d9-540d7204bc7c,1,0,0,0,1
8f2374c6-9a33-4940-be0a-311cb6c5ef1c,5,0,0,0,5
8f2e2d80-4424-4851-90ad-ed10eb96f6a9,0,2,0,0,2
8f4dd475-3d28-413f-ab69-1d56942ccb63,0,2,0,0,2
8f87795e-bc0c-4dc0-9ca4-11e5cad35d77,0,2,0,0,2
8f92ea05-c755-4b00-910f-b19b436ffa4b,0,6,0,0,6
8fa87dcf-7530-44b1-a44b-689f61056acf,0,5,0,0,5
8faab6f5-46d1-46b3-bb68-f49f1154ad0a,0,5,0,0,5
8fef9fab-4920-4b12-ba44-06afda19d35f,0,4,0,0,4
8ff658c0-181e-448a-b14c-18ab78c4f842,0,4,0,0,4
901eb2ab-acd2-46e7-9e7d-461a1cf8bdea,7,0,0,0,7
9020cceb-a571-4d73-9e50-d57325066a83,4,0,0,0,4
903c3acc-99c4-4372-af70-f90f332bd37f,5,0,0,0,5
907e4e8d-530f-4301-a537-1fe7b00c3893,0,6,0,0,6
9099728e-b232-4602-97a0-2e62f84a12e0,4,0,0,0,4
9148d3cd-4f3a-4442-915c-3057d424ecff,1,0,0,0,1
9148fbf7-01f6-42a7-8014-f49afe1036bc,4,0,0,0,4
916f5006-df6b-4f85-b7ae-3db955d7301a,0,5,0,0,5
91737731-3a25-49c9-ac07-ded2f136fc92,5,0,0,0,5
91a4c9fa-f71b-4681-a92a-975ee75e9b13,0,2,0,0,2
91df8295-572b-41db-8d4b-7defcfe68ae1,0,3,0,0,3
9228e488-9c13-4bfd-9281-8d625ff577c4,0,6,0,0,6
92439442-0fc8-41e7-b589-67493a6d1064,0,1,0,0,1
925565fd-5c81-494f-a0fd-ee393a8f7581,5,0,0,0,5
92da0797-4d5c-417a-991b-92ae5b4bea80,5,0,0,0,5
9333f417-473e-4769-9020-1067583486a2,0,1,0,0,1
934c8a78-0596-4a34-9db6-abb2834f65a2,3,0,0,1,4
93a3713f-519d-43a6-acfa-ea539714c92f,2,0,0,0,2
93bc2a4f-47cd-4897-9ab1-361ffc1c4a78,0,5,0,0,5
943f1282-0be8-4b63-851c-0d39a28b590e,0,6,0,0,6
9478285e-65ba-4312-98b1-a55a84ddc72b,0,3,0,0,3
948346b3-c534-4587-a6e6-069ceea72cdb,0,4,0,0,4
948acb1b-4887-4464-8620-279e40d877c7,6,0,0,0,6
94b0a466-93d2-49e3-baa9-c114dd1e0efb,3,0,0,0,3
94cb3905-c497-4f4f-8f60-2da11beede97,0,6,0,1,7
94cdae13-e3b7-43d0-ab98-89e0057d783c,0,4,0,0,4
94d78cd4-6516-4ee6-a7f9-36d453ee6190,0,5,0,0,5
94e2394e-1a2a-4683-818e-f648526df8ef,0,3,0,1,4
9539c05d-9c48-4cb7-9cd6-b22a3737d3b8,0,4,0,0,4
95e8b4c6-8934-4b63-88ca-7f876663e901,5,0,0,0,5
95f64259-4402-46e2-bc41-28b1c8c6a2c6,0,4,0,0,4
964a9f8c-d3f3-436d-9796-322e1065f7e2,0,1,0,0,1
964b7b5a-63f2-49e0-bb53-ee76dfac37cc,0,1,0,0,1
96c61e59-ffdd-4968-99ab-64a72b3491a0,4,0,0,0,4
96c81f98-973f-4996-bfa3-a0cfdcf6ae1e,6,0,0,0,6
96eeac66-afe4-4223-b9a3-0493507677ba,0,4,0,0,4
96f27032-45e9-4336-a915-3a4f02a4cffd,7,0,0,0,7
96f4fdf7-7efb-4298-a118-3048b3cb9b10,7,1,0,0,8
9707fcc0-aaef-4476-925d-b94422576f29,0,1,0,0,1
97444564-138a-40b7-be20-e5b74d4e7011,0,7,0,1,8
97899b54-9077-4eb9-934a-d8cbf1c80053,0,4,0,0,4
97d6668f-fa05-4ef5-92cc-97a0bb23ef2c,0,5,0,0,5
97dacb05-d9b3-4cf9-ad0e-31483c72b662,5,0,0,0,5
97f3db8d-2331-4efb-b940-68e0dba4d812,0,4,0,0,4
985f80d9-ded9-40d2-ad3b-a5fd89f5a798,0,4,0,0,4
988b87a9-bf89-4a3e-b964-84cdfc000e30,4,0,0,0,4
98950a68-603c-4d60-9ba7-ce7d68d89bbd,0,7,0,0,7
989aa1d3-0f05-4f0d-9f0f-da1f2f6902dd,0,1,1,0,2
98b66573-db2c-42ee-9308-a03995acb03c,0,7,0,0,7
991ad67c-fcf7-417d-9b91-c672c70a6b35,4,0,0,2,6
99437a97-539a-45c6-9fba-68a4ec1b6e87,0,2,0,0,2
9944185c-5758-42a3-95d3-774003bfefae,0,2,0,0,2
994dfea8-aed3-4eee-b567-62a32974270a,0,3,0,0,3
99e6c9bf-5add-4a8b-a1f2-7f0f0bfe2188,5,0,0,0,5
9a31e5a7-f932-425b-809b-539a37c63882,0,2,0,0,2
9a78cea3-ace7-4962-8012-5bf2f639c859,0,4,0,0,4
9a8980ef-174d-4aa6-8f52-d8b63b4cb767,0,4,0,0,4
9aa61d49-d4e8-40ee-a585-2a0bd54f7ee5,0,3,0,1,4
9abf373d-f6c1-4260-9eaa-f146da33ffdb,0,4,0,0,4
9ad95883-ab98-45b3-adcc-32af8fbcbaa0,0,4,0,0,4
9b3e5d45-3ea7-4201-862a-d81139b96551,0,7,0,1,8
9b40f5dd-5fa9-4868-be0a-b1ddff86f4b0,3,0,0,1,4
9b487a08-eb78-47e4-88df-177dec036513,0,6,0,0,6
9b90032f-55ee-4fd0-98d3-09877666c398,0,2,0,0,2
9c10aaf5-c2da-425d-a7ac-ce20ee180c94,0,3,0,0,3
9c8ec362-f080-4836-bc60-58817e8ad948,0,5,0,0,5
9caf2ffc-33fe-45ab-893f-816812ba0192,0,5,0,0,5
9cbdf873-79f5-4d33-897e-d8574f995d82,0,2,0,0,2
9cd5247b-62dd-4747-81c2-82352ed082a7,0,6,0,0,6
9cf061a3-f7f3-40e9-992c-1acef0a879b2,7,0,0,0,7
9cf58140-906d-4a79-a683-2aad95155cc1,0,5,0,0,5
9dae2ab2-93dd-4192-9a08-769182bf9f9f,5,0,0,0,5
9e24fd40-a52e-403b-85d4-95f2b551667f,5,0,0,0,5
9e920003-6c57-4ca7-bbd9-53fa1429700f,0,6,0,0,6
9f39345c-b5a8-4278-9636-748ae38ec5cc,0,3,0,0,3
9f715ba3-4aff-42c1-8530-a49e2d527484,4,0,0,0,4
9f924136-b75b-478f-9230-ae98646707fc,0,5,0,0,5
9fad6041-44c4-423b-a695-f1ca69f8ccc5,0,4,0,0,4
9fc653c1-6142-4bb2-99cf-31c26e929313,0,5,0,0,5
a0388667-945d-42d7-9b09-c4d85cbb1e03,0,2,0,0,2
a0b537ba-8add-4fd3-93c8-858fbb3b75cf,1,0,0,0,1
a10f72c4-7299-4bbb-add0-a9f4b68ef580,0,5,0,0,5
a1585c4c-503b-4463-87e9-4439037d097f,0,1,0,0,1
a180a0ac-be7f-4a6f-80b6-3117b7c32a89,7,0,0,0,7
a1bb8bb5-a4ec-4643-b292-4562c5180c80,6,0,0,0,6
a1bbfe6a-ae03-4880-b6c3-782c90c6e23c,0,1,0,0,1
a1e1e12c-c672-4422-9872-578017239762,0,4,0,0,4
a29861d6-6383-48ae-b642-6aa0c04fba41,0,6,0,0,6
a2e93b5c-14ed-4ce3-90ae-1d91ba3979ea,0,1,0,0,1
a35028e3-5a4e-426f-809c-b89692e5644b,0,2,1,0,3
a3dee601-c0b6-4a2c-8117-c27423f22682,0,6,0,0,6
a40e5ff1-89ee-421f-af14-5f79e616d40a,0,5,0,0,5
a49e1bfa-6172-4e13-9af7-4c70a60bfe3d,2,0,0,0,2
a4ede355-22d8-47ac-9b91-9b34a0ba75b2,0,5,0,0,5
a4fccabe-eba0-4b81-975a-379aef684823,0,4,0,0,4
a532fd51-eb12-41c8-b288-4ecbf8d89f86,0,7,0,0,7
a5374683-a893-4d07-8178-f8b37a3be1df,0,4,0,0,4
a58eaa67-922f-45b9-8da3-c35c7161a889,0,5,0,0,5
a5df2728-0c05-4435-8280-7c6926b6804d,4,0,0,0,4
a6680e72-ef0e-41c0-a178-a4a9646ec103,0,6,0,0,6
a687cdbc-e2e1-4516-b700-22de6be1163b,5,0,0,0,5
a6a44da2-94fc-4ccb-80cd-da9a491e48ac,0,5,0,0,5
a6b40c3d-7920-47ea-8a3e-56e4ab7c5857,0,7,0,0,7
a6d5cbd9-a20c-431a-ac55-81a76dd02651,5,0,0,1,6
a6f22f17-1d09-47a7-bc0a-c7a46e4e228f,0,6,0,0,6
a766f060-9f6c-4048-bc4a-2fa74054a8e2,4,0,1,0,5
a80fb843-41f7-4991-9b12-7c07f7d08537,0,4,0,1,5
a84a5712-6f91-42dd-ac5f-a92cc6b609cc,0,5,0,0,5
a8e00ea5-9f90-404d-8acf-25fc705f35d5,3,0,0,1,4
a8eadf17-c578-4792-93ce-6058af2da541,5,0,0,0,5
a9c55f9e-cb8e-42ac-b354-77791c69ec68,0,5,0,0,5
aa16b60e-94f1-4174-94ae-2ff14ac6d4bb,0,8,0,1,9
aa2d427e-b208-485a-a67e-1d21552ad975,3,0,0,0,3
aa8bd5aa-9b5f-4472-8fe8-3127c8480260,0,5,0,0,5
aa9427d0-2532-46e4-8570-ff3a56bd51b4,0,5,0,1,6
aac91642-2261-49fd-94c2-1689ad7dbeb3,2,0,0,0,2
aad7251a-53dc-482f-a3a3-c16f4de0c383,0,6,0,0,6
ab233bce-5f48-4094-b1ea-58dc60308f05,0,2,0,0,2
ab835559-ef9c-4ead-bfa4-002ae60c42fa,0,1,0,0,1
abe261b3-7021-4ae8-b553-01117cfdf640,4,1,0,0,5
acb3c59c-1847-4b29-8d6e-f1f939b0ac9a,0,4,0,0,4
acd490b9-e4bc-4642-bfa6-f24ceff09531,0,2,1,1,4
ad639bfe-d380-462a-8ff8-ad7a974a3d6e,0,3,0,0,3
ade23151-6722-4bed-8397-d1547f39775a,0,5,0,0,5
ade676de-1977-4f86-af97-e5d723324f4b,0,4,0,0,4
aded4ad5-c886-4cc8-b296-fd55eb7073b5,0,4,0,0,4
ae1d9a19-6820-4911-8b68-aa31b40a10dc,6,0,0,0,6
ae268dcd-934d-4931-bcf3-4eb5ce177827,0,4,0,0,4
ae2fc4bf-eb5b-4f1b-856a-bdacd5519d62,0,7,0,0,7
aeb142d4-f4f9-4ce8-9c15-b3ea20a3eb60,0,4,0,0,4
af1b77b9-0800-497e-9430-5b768f3c4114,0,4,0,0,4
af3a009c-a05d-42b6-b3cf-cf8f3b39b9be,0,2,0,0,2
af55fb3e-301e-47e7-a480-ab1d0aec93a6,0,5,0,0,5
afbddd9f-b3b6-4ac7-af8b-8fdfd5feace5,5,0,0,0,5
afdf809e-e433-4ef0-899d-7feb176030f4,0,6,0,0,6
b03e8751-8524-41f0-814a-a204eed11b7a,6,0,0,0,6
b0643877-561c-416a-919b-1b3bafdbdf79,0,6,0,0,6
b08d1a29-9a45-4388-97b3-12eb31062caf,0,9,0,0,9
b0b1ccdd-a7a6-442e-9a8c-6b52d89f4031,0,4,0,0,4
b0ff7e2e-f8e3-4500-a3bd-66e6003457cc,5,0,0,0,5
b13392e3-aa01-4e3a-8b75-141701f1d5cf,0,3,0,0,3
b1347d3c-9f54-4daa-a0c9-2f902a510374,5,0,0,0,5
b168cdc2-b2ce-4541-95de-04f8218578f0,0,2,0,0,2
b1cc6c8b-983e-41b3-8203-aadac68635e5,0,4,0,0,4
b1d6451c-4c60-4b69-93c1-3ce0be56662b,0,4,0,0,4
b21a23c0-b1d3-4491-a898-56af24e27d15,0,4,0,1,5
b2263c53-e921-47ee-be84-6334afebbd7e,6,0,0,0,6
b23b235a-9a0c-4105-a929-c1e60347143b,0,1,1,0,2
b2697f5d-9ef9-418f-93b3-4e910578e847,0,2,0,0,2
b28235f0-617e-4575-baef-5f126ebde15c,0,6,0,0,6
b29d5cb2-d040-45c6-b971-3cb3ab2d196d,0,5,0,0,5
b30eff91-f662-47ea-a5ef-68223120681b,0,4,0,0,4
b37d947c-0b67-40a6-ac6a-331aff6613cc,0,2,0,0,2
b39d761f-c1c9-4767-9bcb-8945fdf5d810,5,0,0,0,5
b3ad3c97-d5af-4b93-b82a-58e4e233c410,1,0,0,0,1
b3b96af0-73c6-4983-81f4-2ba0b3a0f0fb,0,1,0,0,1
b3e9040e-f673-4d80-b6b5-455c94726b90,6,0,0,1,7
b424afb3-b5f2-4810-b045-f86223739e5c,0,3,0,0,3
b43e748a-f1da-41e0-b84b-a7980e6eee90,0,4,0,0,4
b448c9f5-5687-4fdd-ac01-d4239fcaa714,0,6,0,0,6
b47bfc49-345a-4512-9f9f-f2b8da45e36b,0,4,0,0,4
b4c9d687-aa89-4e8d-9b28-efd7ece6a5e5,0,3,0,0,3
b5622fad-1210-4e8d-99b0-17c0d953b1a9,0,2,0,0,2
b5e704bc-d0d1-47d0-977b-852d607852f1,5,0,0,0,5
b61532ee-38d0-43f5-80b4-1a73987431e8,0,5,0,0,5
b6b90505-6061-4734-83ff-c6bc440b5c27,0,4,0,1,5
b6e5e278-8b35-48dd-a5fc-b281dda43ce1,0,2,0,0,2
b6f33fff-337f-4916-9d80-bf57b0b3674c,0,1,0,0,1
b72ff202-a0ca-43e2-b36c-43566442d5b7,0,5,0,0,5
b736a7f9-948e-42c1-9c02-e55454231a52,0,1,0,0,1
b7e4e82b-13d8-40f7-b741-e04689428441,0,6,0,0,6
b825cc7c-645e-42f6-9b99-5dcdf90f54c0,0,3,0,0,3
b83e78db-1705-466e-8d2f-12acdc37f936,4,0,0,0,4
b8531e68-59c8-4327-88b7-6e910164b0af,0,3,0,0,3
b884c0f3-64f4-4dc5-a995-b26e7c24feef,0,4,0,0,4
b8fad874-b6e8-4f3f-8856-dc9775d77221,0,2,0,2,4
b90b1df3-d5da-411d-9efb-b74aac682e81,0,4,0,0,4
b90df32e-7aaf-4770-bc5b-80e30c2cf6c0,5,0,0,0,5
b90eefd2-9fa2-4018-a8c7-0d133b620b91,5,0,0,0,5
b955c6ac-4c9e-47fb-b37f-4247972ccd49,1,0,0,0,1
b9599f5e-aa8f-4b34-bace-9f8dd4263e42,1,0,0,0,1
b97d421f-8e91-476e-a6f2-15865a39337f,0,3,0,1,4
b98a6135-418b-4b02-ac6c-61ab63bf2ac1,4,0,0,0,4
ba40ad4e-7370-46ee-a4b1-3700898d8849,0,4,0,0,4
ba4ac0e6-b495-423b-a77f-ed99d55a85bf,0,4,0,0,4
ba676b7d-913f-4313-8812-4bec85f3a4ff,0,5,0,0,5
ba67d321-2d8a-4963-b5c1-4aa2f13b6552,0,2,0,0,2
ba69703b-c005-47e9-84e7-834ed529266b,0,4,0,3,7
ba7e8923-903d-41f1-81eb-3032353df181,0,4,0,0,4
baa5104f-5f43-4884-9dc8-4766ccb132e0,0,3,0,1,4
baca963a-9617-4c3a-b40f-5ab42a663503,0,2,0,0,2
bb27557c-8c76-4d39-a745-d367ce6c7a3d,0,2,0,0,2
bb6a9640-e3f9-4a91-94c4-6630e68d62ef,0,1,0,0,1
bb72bb69-8f73-4599-89c3-6669b382bcd4,4,0,0,0,4
bbaca672-aa54-4653-927a-fd912ccc488e,0,5,0,0,5
bc0a346a-05fd-45b0-a5fc-47f473cecde3,0,6,0,0,6
bc1b31c5-f020-4527-9fbb-c04069c0c6fe,0,3,0,1,4
bc1daaa6-536a-410e-a432-3aaac98f082d,3,0,0,2,5
bc2ac788-e57e-469f-b24d-afd2c13fe3e9,0,4,0,0,4
bc35e2a0-99a7-435f-8497-05d41152fa06,0,3,0,0,3
bc5f2546-408c-487b-b0f3-e32d4da365cd,5,0,0,0,5
bc784d8b-49a0-440b-8124-0ed41971c63f,0,6,0,0,6
bd098a08-cbc4-4447-819a-9d895bdcd983,6,0,0,0,6
bd62e778-0d48-46f7-89b9-43a1d08e6395,6,0,0,0,6
bd664e33-26d1-49bc-83f0-39e95af6cacd,5,0,0,0,5
bd6b5510-e907-4629-9b53-a3f94c8b0002,2,0,0,0,2
bd7c0cf1-2e0b-4d16-94c0-d4558486afbb,0,3,0,0,3
bd810cac-9c78-48e5-83f6-2d3fbf89edfe,5,0,0,0,5
bdec976f-fc76-4fe3-b9d1-3214a748ec0e,0,5,0,0,5
be53e314-58a0-4553-876d-eee87252b56b,5,0,0,1,6
be6753cd-706d-4379-bcb1-2b1492fdb9ee,2,0,0,1,3
be6999bc-2f50-4e7f-b2b2-7604c92057b6,6,0,0,0,6
be843c2e-2f63-4473-8cd5-372ef23462d0,0,6,0,0,6
bf6fa87f-1fa9-4802-bf7e-ac6455a5f498,5,0,0,0,5
bf79d075-f0f3-4ebb-bc9a-2fc14570a4eb,0,4,0,0,4
bf8b478a-2eca-43af-9c73-cca91731fd03,4,0,0,0,4
bff0a53e-d34e-4903-b71f-f2ea0a8c8039,3,0,0,0,3
bff95fd8-e4cf-432f-9db9-f770ddd5e50b,0,1,0,0,1
c037c0c7-e58d-4a64-a24d-a8908f597ce6,0,5,0,0,5
c055c7ff-1afb-49b3-aedf-9521f40bb903,0,4,0,0,4
c0854dac-e6cb-425d-9df4-f74563de3963,6,0,0,0,6
c096f1b7-90de-4fb0-9f99-84fc00c2c773,0,4,0,0,4
c0a69a68-92f2-4c21-87ea-10382e1a7c05,0,3,0,0,3
c13e77c9-e9a4-4c9f-8e54-041af3183e57,3,0,0,0,3
c1583e23-4755-4c25-b34d-bd3883badfaa,0,6,0,1,7
c1a67dee-022b-4f1b-8728-a4b556a13227,0,5,0,0,5
c1b3c19e-3948-4580-b20a-21a8dfdb2297,0,4,0,0,4
c223c847-d228-46b5-8acf-98ad6021c8f9,0,6,0,0,6
c274a5a4-69c1-4723-bf05-e94daa49fb45,3,1,0,0,4
c2870bf2-9b8c-4054-9c20-065b8eaf79f5,7,0,0,0,7
c2b0c625-d747-4c15-aecb-9bae3f7d05a7,0,5,0,0,5
c2c2878f-bb50-49e8-bd61-888c60c6ab86,0,4,0,1,5
c2d50585-6673-4bd2-bdba-dd3f9dcc9196,0,4,0,0,4
c30c2858-599a-436d-b8b3-ad27656317e7,0,6,0,0,6
c30e52cf-da8f-4f40-aa21-c761d21bdb85,0,1,0,0,1
c38a93ea-cc7f-4d24-aae5-bdd9a6bb4858,0,6,0,0,6
c3d231a1-a9a7-4c06-8d8b-b7112269a55a,0,1,0,0,1
c3faa4e6-56de-4571-8eb9-01c6e5e1d707,0,3,0,0,3
c4bac544-25d6-45d2-b02b-32582e152d89,0,1,0,0,1
c5460ece-59dd-46e6-a0a0-43b6e4729ff8,0,2,0,0,2
c5464fad-fdca-465a-afcd-de28649b6fa6,0,7,0,0,7
c572b6a6-22e7-4340-a8db-77a6763e291d,5,0,0,0,5
c579b2ef-e6ee-42d6-98a9-21e001875f35,0,1,0,0,1
c580ec27-b164-4fcd-807e-3b7de5aa48e9,4,0,0,0,4
c5949924-4018-483a-9a8c-843516fee6a5,0,5,0,0,5
c5a78679-f8d7-4ddc-8716-1f5657087f5d,0,3,0,1,4
c5ad64f0-3512-4de5-bcc3-f63c67d15a47,0,4,0,0,4
c5adef02-23f3-44c8-a16c-c1b06212af61,0,4,0,0,4
c6088261-4a7d-4e3b-a538-fd5b140ef1b9,0,6,0,0,6
c7a4f56b-e7ef-4eab-a61d-1363afbaa1a6,4,0,0,0,4
c7d093d9-7689-4c73-aaee-3e90576fa3b4,7,0,0,0,7
c7f0bdeb-3dfd-48e4-9a03-2a26186c8d60,3,0,0,1,4
c8337342-4b54-4b50-8ee9-42e3910eabd1,1,1,0,0,2
c8e8352f-c350-489e-aa9a-8f7dcef97f71,0,6,0,0,6
c8ec4c89-5df1-4d2d-bb01-2d68a22f7691,0,4,0,0,4
c93d1de1-5a93-41f3-bc65-5701294a5da9,7,0,0,0,7
c95222ed-4025-4158-a55d-09d841683bad,0,1,0,0,1
c95417b7-ba93-47ba-94b6-7529a093abb5,0,6,0,0,6
c9bc03c2-a607-49b7-8f70-7f6bd8f4b73f,5,0,0,0,5
ca1870ff-4f3c-46c1-9368-677d6c64644d,1,0,1,0,2
ca47bf9c-7187-4ff1-862b-decd8abcb623,0,3,0,0,3
ca62ffdc-cf62-4252-9df9-bcfb27f4a732,0,5,0,0,5
ca67fc42-6e16-46a9-b424-ce59503f6882,0,6,0,0,6
ca979b4b-f6ad-4fd6-9fe1-56e6053a906d,7,0,0,0,7
ca9a3e19-e0cc-40ec-9908-c986bd1d85ac,0,1,1,0,2
caef0110-fcc8-4032-9a81-98e75a1cfc38,5,0,0,0,5
cb37f38e-bfb0-4bbd-aff9-c2c8391f958a,0,2,0,0,2
cb496160-1038-4ced-83f5-95621542aea2,0,6,0,0,6
cb4f2df7-b726-46b6-8f58-1ca7497ef3eb,0,2,0,0,2
cb68edea-26fc-4fcc-ab86-83ae332420d1,3,0,0,0,3
cbcbd883-a588-4cd4-a217-70fcb6d47d94,0,2,0,0,2
cbf4d9e5-cb40-4973-867f-1fa447eda8e5,5,0,0,0,5
cc51aa27-a258-4ad4-ae57-93c1eec58b41,4,0,0,1,5
cca3809a-5e89-4f5e-9a91-94def7653170,2,0,0,0,2
ccaa94ce-8eb3-4b6a-b26b-1158d46db6a5,0,5,0,0,5
ccc94d7a-684e-463b-9723-e354fdc058aa,4,0,0,0,4
ccdea84c-1af6-46b8-837b-f9317dfc3f30,0,5,0,0,5
ccdf08b1-544a-42f4-aaad-f0f5620e12d7,6,0,0,0,6
cd208e08-fd01-4d20-a1fe-27262c2d89cf,0,1,0,0,1
cd278c7b-91ae-44f7-b0c2-2e01738defb6,0,5,0,0,5
cd32a2b3-51b5-4e58-8259-80486ab8de8f,0,4,0,0,4
cd444e8d-4ebe-4298-b104-91c8c11cb673,3,0,0,1,4
cda62ae7-5d48-412f-81aa-335e14aeff8f,3,0,0,0,3
cddcceb0-2045-4044-95db-8ec3abde2072,0,1,1,0,2
ce234ce9-c67e-4f42-80be-96563c1f8fae,0,4,0,0,4
ceaee0b8-52e7-4874-b2c3-182b3c5250b8,0,5,0,0,5
cf52e70d-f00b-46d9-a217-f347b50fdb8b,4,0,0,0,4
cfd1ed21-dedf-40ad-b6cf-5086c4ce62dd,5,0,0,0,5
cfeae2fb-e110-43b8-8f6e-cd925e21483c,0,3,0,0,3
d07efda7-d813-4f03-8ee6-e71423a2e478,0,5,0,0,5
d082456b-b46f-4e5f-ac85-1dd9e246304b,0,2,0,0,2
d0b6eaa2-3905-488c-9340-ba556f0124ad,5,0,0,0,5
d0d74c90-effd-4dac-91d0-154decff26fd,2,0,1,1,4
d11dcfbc-39bc-46f7-9c23-cee84165baf0,6,0,0,0,6
d131af7b-feb4-473a-a14a-524198bed677,0,1,0,0,1
d13c8091-1e2f-484e-aee3-52a212565bba,0,5,0,0,5
d166391b-c7eb-4922-bbd1-1a61992c215f,0,1,0,0,1
d168d6a6-da54-445a-88aa-e3e6c5e5e0aa,0,4,0,0,4
d1acbf2c-e9ac-4c23-918f-a166427de108,3,1,0,0,4
d3403426-a325-4571-9055-16ab6f213962,0,2,0,0,2
d3a693ca-878f-4995-98f2-084be9ab0c85,4,0,0,0,4
d3d27f77-b848-4084-b71a-6ac7d89882db,4,0,0,1,5
d3eb31b0-44e2-46b6-9e1d-ba05310f59b3,0,6,0,0,6
d3fbae48-0cd9-4fb9-980e-eb393ded28e7,4,0,0,0,4
d43c321d-d130-4e81-b402-36f4c14b9708,0,4,0,0,4
d44ff3ce-4f80-4a76-93e6-e5c2c23b1f8b,0,3,0,1,4
d528291f-7b8b-429a-a650-e74a693ca7f4,0,7,0,0,7
d52e0d59-69c6-4f56-9713-2a59979fd725,0,2,0,0,2
d57b286a-93c9-412e-929c-5cdd2343e020,0,4,0,0,4
d5ed3ccb-ff8d-4ed3-868e-78c6004839ad,2,0,0,0,2
d5ff859d-a66a-49b2-b3f1-872ed2cc9298,5,0,0,0,5
d6036167-643b-4f5f-b7fd-b2170ab3627e,0,6,0,0,6
d624c8df-38e6-4c2d-a39d-0e840aa11d86,1,0,0,0,1
d666b014-da6d-46d2-8456-7f2eaed1e63e,4,0,0,0,4
d6940198-7fb7-419e-aab8-71ed0c61b390,6,0,0,0,6
d6a6fd9c-3903-44bc-81f6-5c762d49d113,6,0,0,0,6
d6b88f66-8836-4193-b981-88dfb5a0eaf9,0,5,0,0,5
d6cae64f-50bf-44a1-8475-3577f5ad3151,1,0,1,0,2
d6d5bc34-3d43-4a2c-bf37-b56e24f402ec,4,0,0,0,4
d6e64697-7dd3-4d31-b77f-cafa517c650b,0,5,0,0,5
d7053776-ff87-47db-b69d-6cc66e9ddaa3,4,0,0,0,4
d705ccdd-9604-468f-96a9-eb579b3a7102,0,6,0,0,6
d707d13f-8172-4427-b86c-93a8aad09c06,0,3,0,0,3
d70bc47d-523f-4a55-a91a-21a1d6f65d17,4,0,0,0,4
d7583700-c248-417e-a8aa-0ce07c2fe82c,1,0,0,0,1
d77ee4b9-ab3e-4b67-aa18-8c1d9387547e,0,1,1,0,2
d78f44f9-e68a-45b7-9eca-9b1d9bb20b44,2,0,0,0,2
d803858c-d6bd-4229-b635-442e88c313bd,0,5,0,0,5
d83ea7c0-298b-438e-b4e0-37686df88276,6,0,0,0,6
d84f73ce-3427-4204-a6fe-5b919795f90e,6,0,0,0,6
d8509824-2e77-4310-bf39-893bd68d9535,0,3,0,1,4
d8a7b86e-d3c8-44fd-9eeb-63a56e7166d2,0,4,0,0,4
d8ae36d2-de69-41f3-80e8-3167459239cf,0,6,0,0,6
d91b082b-4493-4478-baca-9a2c87bd9290,0,4,0,0,4
d94e5b0c-5f35-422e-b2e3-c860cadd53e7,0,4,0,0,4
d9ac6823-c158-4673-90e9-6ff1d8291ebb,0,4,0,0,4
d9ce635f-996d-4c3b-9c14-ceda5fb68a15,5,0,0,0,5
da711f04-0e20-4031-b20f-d2abdd741a84,0,2,0,0,2
da8557cf-42af-42cf-9e51-819f6c98cb8a,3,0,0,0,3
dac7ee7b-737f-4056-be3b-d8890a56dbb9,0,2,0,0,2
dae76e7e-2134-4af2-b3df-8c99587ef7ee,5,0,0,0,5
dbb0fb7a-8b5a-4093-8f1a-f1561557402f,0,6,0,0,6
dbf1eba0-eb3f-4888-a808-28fea2b61557,0,4,0,0,4
dc66046e-2d61-4650-ae45-c648cc7bdba4,5,0,0,0,5
dcca4bb4-01d6-446e-ae0b-2a1d60ab6bd0,6,0,0,0,6
dd09894e-6a66-4054-b583-f5ba2febdb1e,0,5,0,0,5
dd1b3547-abfa-4d13-b5ca-6b36126692ba,0,4,0,0,4
dda03aed-fd98-4159-a0e3-02b3eeefec86,0,2,0,0,2
de5c6027-2883-49bf-8c5e-f75e28e52cce,0,6,0,0,6
de5cc803-408f-419c-afd5-fd701194dd2f,2,0,0,0,2
de6c7d2f-1387-433f-9fb2-a423f0780900,0,4,0,2,6
de6e3398-14d2-4626-ae3b-2ba4b75be5d4,6,0,0,0,6
deb38a69-6caf-42ea-a5e3-c0f08e1de73b,0,2,0,0,2
deb84cf7-de86-4ad0-ac92-a2870b81699a,4,0,0,0,4
ded212b3-c8db-4cd1-b3c3-e58f0a702cef,0,5,0,0,5
df76775c-8826-4c79-b79d-eb10f8ae78ee,0,5,0,0,5
df80c2f1-a973-4f3e-a938-772950a334c8,0,4,0,0,4
e08d88c6-9e8f-423e-9e16-855a0fc1b71e,3,0,0,0,3
e0a1b3a3-d4de-45c6-a74c-261d37922efd,0,5,0,0,5
e0dd960f-fc1d-42d5-9288-8e65c1fe96d1,6,0,0,0,6
e0f52520-5bb2-4d93-8913-6a6e28bd35f1,3,0,0,0,3
e224d66b-5aaf-4b00-89e3-104d45056b57,0,4,0,0,4
e23d388a-d1f8-4116-9909-fe5322ab3e97,0,1,0,0,1
e260add9-e57a-4765-848e-d44bdfdea215,4,0,0,0,4
e2926a65-7d39-480e-8965-83d26e0a2bb9,0,2,0,0,2
e2a1724d-7696-4214-acf4-3179f4a55279,0,4,0,0,4
e2b223ea-b616-4e7a-8245-2a94461c1ea2,0,4,0,0,4
e2ef52ea-39e5-4dc1-ac44-a36b850d42f1,3,0,0,0,3
e2f222b8-35fa-4a27-8e1a-785dac550bc8,0,2,0,0,2
e3529c6a-83a2-4699-8f49-2b34fdcd05eb,3,0,0,0,3
e355a34b-68e1-4400-8b9f-4076f6b4fb72,0,4,0,0,4
e3e3b67b-688a-4233-b1a0-dd1f6c041179,0,5,0,1,6
e3f1c196-affd-4e55-ba90-07f736e83f9b,0,4,0,0,4
e419af76-1111-4812-bee9-782dc3977c35,0,5,0,1,6
e43b4f40-5640-4a1b-82e8-0ea27b036fad,0,2,0,0,2
e4c74063-677b-4313-a459-e5e58e3faebb,5,0,0,0,5
e51a7409-d81e-4c5b-8fd1-977c0b35589d,0,4,0,1,5
e5520ace-e418-4326-ab79-b819b6c3e75f,6,0,0,2,8
e596c220-0003-4151-9857-42e2f79994ac,0,5,0,0,5
e5c91925-c773-4268-bb62-e6cfb9518e3c,0,5,0,0,5
e5dd6c97-b55f-43e2-b069-0e1cbdb79aa8,0,6,0,0,6
e64bd64d-4427-4ff7-bea1-8ea6b7c31c49,0,4,0,0,4
e6664757-beb3-42f9-879b-65d8427e1f16,0,3,0,0,3
e66c7738-1c41-485b-be1e-4784497953ab,0,6,0,0,6
e6703c36-285c-4d68-b631-b65ca8a08538,0,5,0,0,5
e732ff0c-942b-452a-81f2-1d74a9bcb9b9,0,4,0,0,4
e7a897a7-4254-4916-b95b-032f577ea28d,0,4,0,0,4
e800860c-7a28-4f95-95ca-244bb67a5291,3,0,0,0,3
e80c8a2a-c9d5-4d72-bfe5-16ee00688375,0,3,0,1,4
e94761d3-726c-43fc-b58a-b64b86a39730,4,0,0,0,4
e977f1de-18f2-455a-ba55-f2d0b9c90f46,0,7,0,0,7
e9a2ef9a-d4d2-45f8-9b18-72f160002c5b,5,0,0,0,5
e9d9a99c-ed7f-4abf-aa44-5d2233040cfc,0,2,0,0,2
e9e01962-0b9f-435e-aa8b-5ae4817af52e,0,5,0,0,5
e9e28a37-8a88-47fa-9434-1ba2eccaf76b,0,6,0,0,6
ea08bf68-959c-499a-bf19-868828b2e3b6,4,0,0,0,4
ea3d2570-c210-4014-a9fb-f9edf6544c2b,0,5,0,1,6
ea7eb6e5-3c3f-47e7-afaa-7231562c3ded,0,2,0,0,2
eaa830ed-4ccc-4b38-aadc-63ba2a8c6086,0,4,0,0,4
eb1bb4f5-33b3-438f-a043-cd9d65b95b06,0,4,0,0,4
ebab51b5-5c5b-4aad-90b0-372a18db1da4,0,4,0,0,4
ebaf42fe-1a3b-4c97-ac53-f741f0ec1581,5,0,0,0,5
ebc5a9e3-9e3c-495e-bb94-a012534dea7d,0,4,0,0,4
ebe2b013-329f-4af8-ac12-395692eecbba,0,5,0,0,5
ebe52cb3-2c83-451d-b53a-7778ef10871a,0,4,0,0,4
ebfa96ec-64d3-4375-8d9b-1357e641e247,0,2,0,0,2
ec067791-6d2c-4a11-9363-b37dfad3d59e,0,4,0,0,4
ec1b3cb3-c4c0-4022-9c11-6d8ad4b56e66,0,6,0,0,6
ec791539-7714-4ae3-97ab-8fb51bb5af7a,4,1,0,1,6
ec83c452-314f-443d-b524-29cbe87f8330,0,4,0,0,4
eca8668b-effa-4bb1-9d4f-a99176ef7b60,3,0,0,1,4
ecc86ec9-cdbf-40dc-a668-146d28729126,0,4,0,0,4
ecd51d80-6dda-4f79-9ba3-fc9c383e4beb,0,6,0,0,6
ed8e44e5-8288-4430-9e8b-40ec3bdab287,0,4,0,0,4
ed9a5c45-39c1-4627-811a-5af8cc1923ed,2,0,0,0,2
edd32d4b-a8b5-4ec2-9a75-54c7b56659a4,2,0,0,0,2
eeecb3f5-6429-4575-a560-5a5827cb968d,5,0,0,0,5
eefc6cb3-012d-4542-abc7-c237fbe66a7b,5,0,0,0,5
ef28caad-d74d-4a34-9a53-cf6e7d33d30e,5,0,0,0,5
ef87e8e7-9e57-4b48-aa7a-53eddfdae1a5,0,4,0,0,4
ef96519b-9d55-4218-837c-7601d3ea2d2c,4,0,0,0,4
ef9ea068-6150-455f-9902-9974cba688df,3,0,0,2,5
ef9f93d0-18c1-4d8a-91ec-f1a0dde17e16,0,7,0,0,7
f0269d6e-17bb-41e1-8940-4ba8e113a023,6,0,0,0,6
f0b0dd80-8bcb-41e6-afe1-4b6afd413124,0,5,0,0,5
f145cf4e-5948-481f-ae60-494f4ae1dac9,0,6,0,0,6
f1a8da60-f854-4292-b3b9-25cc5b207695,0,4,0,0,4
f1f6be3b-ad97-4039-ad4a-2af08e961f7c,2,0,0,0,2
f21e87bf-5fee-4814-a909-fcd0d610a6f0,4,0,0,1,5
f23f7343-a7a7-4f6e-ba9a-034bfb2ba311,0,3,0,1,4
f2f9cd26-b520-49d6-b861-e2aaaf87e1eb,1,1,0,0,2
f34755ce-8244-40f3-932a-30bc09a1deaf,4,0,0,0,4
f397f72d-2724-4a62-bfcd-1cdd1b0cd384,0,2,1,0,3
f3b7cba1-efdf-49e9-be8a-a878d2c8bc1b,2,0,0,0,2
f3cffd69-3220-484d-a088-d1516590186b,0,4,0,0,4
f49f52d5-46be-4857-9552-257544b97a80,1,0,0,0,1
f4d3c555-2ee7-4128-a5d7-b7eb7aff253a,0,7,0,0,7
f4e41a47-ab71-46b9-af29-d86651c9316f,3,0,0,0,3
f50b4c3f-3bf6-48a2-a483-dafd2a609122,5,0,0,0,5
f556b4f3-92f0-41ce-a9d9-42c4ae790b7c,6,0,0,0,6
f5596495-d320-4dd3-988c-a6e3c96a9ffb,0,1,0,0,1
f5a9de1a-859d-4a71-9fa2-4bb6502a399c,0,8,0,0,8
f5d02c2d-fd24-49f4-ba54-78d7abb91408,0,4,0,0,4
f5e67ccb-fc2b-4efa-a80f-a6987d33a361,5,0,0,0,5
f60bd86b-3649-43f3-9559-62f48f0909ef,0,4,0,0,4
f6138f18-f736-49ec-9585-67751a6df448,0,2,0,0,2
f656404b-dd5c-4530-8c7b-dea329732795,0,4,0,0,4
f656d01c-6e26-4f1d-90f0-6fac804dc168,0,6,0,0,6
f66e9ad9-03d0-44f5-8271-947b658cf6b7,0,2,1,1,4
f680cd36-a736-4d63-b659-ca4149c16a22,4,0,0,0,4
f68d2c42-2763-421a-b201-2f778df8234a,0,4,0,0,4
f6ae18c9-62c7-4eb1-83a2-d4b85ff3b7a4,0,6,0,1,7
f6d3eee0-dac6-4a31-9524-363339ace0bb,4,0,0,0,4
f747fc08-eaf7-4d21-876f-562296af9ebe,0,4,0,0,4
f766e39b-177d-4c00-ac3e-9eb80a689ab4,0,7,0,0,7
f76ef94c-298d-477f-b85e-c1e4436c807e,0,1,0,0,1
f80c6070-c706-46e4-9fef-5b286be17887,1,0,0,0,1
f8256de5-8982-4f9b-8885-f02d9d5c5e9e,0,6,0,1,7
f82cb848-f9ff-489e-886b-0bb2ad90354e,0,6,0,0,6
f84aa7e0-06fd-4b29-9208-4ff3289cfbe7,0,8,0,1,9
f87740c4-9019-481b-b952-654316997258,0,4,0,0,4
f883e78b-0a6c-4797-91aa-3d7e2252fbaa,0,6,0,0,6
f8a119fc-41a8-41b7-b44e-011bf0713a71,0,4,0,0,4
f943e6aa-3eee-4f3f-bbd1-7a8904ac3804,3,0,0,1,4
f99ff20b-f341-42ed-bb70-5a194655c86f,0,4,0,0,4
f9a90dfd-36c6-47f9-abf6-7d85f987938c,4,0,0,0,4
f9fc2ff3-22f0-4b88-8cee-5e622e8105c3,4,0,0,0,4
fa134372-72ba-4323-8765-f81e4b0db2fb,6,0,0,1,7
fa2a3461-0e5a-4f8c-a091-ffb10461656e,0,6,0,0,6
fa3b9eaf-0d56-4d69-95bc-2b4377526e18,0,4,0,0,4
fa3bace8-1e58-4ca7-8f38-7d97d2f89350,0,3,0,0,3
fa6a9d59-6725-4ad3-b5aa-fb8e544c1c47,0,1,0,0,1
fa6f8ca3-9fce-452f-9665-69c19f0d9df0,0,5,0,0,5
fa828138-a059-44d5-8910-d33f57357245,4,0,0,0,4
fa9cbc36-09df-4281-80d5-1de77f5536a8,0,4,0,0,4
faa2a0d9-8867-47d3-b48a-a27ba1ec361d,0,2,0,0,2
fabfb91a-c62a-480a-aa85-62a79c596630,5,0,0,0,5
fac0e773-11f4-40de-af8c-f6b62c1ce076,0,4,0,1,5
fac7002e-e1a8-458d-b336-4317a42572b7,0,4,0,0,4
fba059bc-f8f0-406e-9ba9-f7e5628e04ab,0,5,0,0,5
fbe5e1d6-64c1-440b-a54a-e8d9be043ce9,8,0,0,0,8
fc131640-cb92-49dc-bce5-21362b6cbbc3,6,0,0,1,7
fc6cb440-97cb-4c33-a87c-2cce12b3dca6,2,0,1,1,4
fc8b3ac3-cdfb-4f36-82cc-9f2af2794c0b,0,5,0,0,5
fc8b429f-e77c-4299-b2e9-6ae5769bd144,0,5,0,0,5
fcabd60e-761c-47de-b973-22201a61c00b,2,0,0,0,2
fd950970-1f7a-4d79-a62d-4d3616e5553e,4,0,0,0,4
fd9bbe25-25a2-4f78-b5ef-3cf01cd8ec8a,0,4,0,0,4
fda314f1-9490-4dde-8ef5-3fd156943420,0,3,0,1,4
fdfd931e-1be1-4daa-adef-82c60e48e107,5,0,0,0,5
fedbf4a2-ed99-4701-b821-3e4a165c16ce,0,4,0,1,5
ff61ee71-3863-4099-b86d-d740870620fc,0,5,0,0,5
